Date;Hydraulique;Eolien;Autres;Solaire;Thermique;Total 
2022-01-01 00:30;24254;599;546;0;0;25399
2022-01-01 01:30;23915;585;544;0;0;25044
2022-01-01 02:30;23201;560;566;0;0;24327
2022-01-01 03:30;23225;620;565;0;0;24410
2022-01-01 04:30;23272;689;564;0;0;24525
2022-01-01 05:30;23353;866;564;0;0;24783
2022-01-01 06:30;24028;935;564;0;0;25527
2022-01-01 07:30;24870;1029;562;0;0;26461
2022-01-01 08:30;25503;1127;563;0;0;27193
2022-01-01 09:30;26093;1342;563;0;0;27998
2022-01-01 10:30;26474;1440;562;0;0;28476
2022-01-01 11:30;26773;1328;562;0;0;28663
2022-01-01 12:30;26618;1277;562;0;0;28457
2022-01-01 13:30;26126;1450;562;0;0;28138
2022-01-01 14:30;25934;1316;562;0;0;27812
2022-01-01 15:30;26629;1025;563;0;0;28217
2022-01-01 16:30;28243;802;562;0;0;29607
2022-01-01 17:30;29955;657;563;0;0;31175
2022-01-01 18:30;28466;532;563;0;0;29561
2022-01-01 19:30;27376;478;562;0;0;28416
2022-01-01 20:30;26658;315;561;0;0;27534
2022-01-01 21:30;26190;311;561;0;0;27062
2022-01-01 22:30;25534;359;562;0;0;26455
2022-01-01 23:30;24428;471;560;0;0;25459
2022-01-02 00:30;23719;578;561;0;0;24858
2022-01-02 01:30;23233;599;563;0;0;24395
2022-01-02 02:30;23543;452;562;0;0;24557
2022-01-02 03:30;24032;410;560;0;0;25002
2022-01-02 04:30;24981;425;560;0;0;25966
2022-01-02 05:30;25556;408;561;0;0;26525
2022-01-02 06:30;26709;479;560;0;0;27748
2022-01-02 07:30;28092;435;560;0;0;29087
2022-01-02 08:30;29119;465;559;0;0;30143
2022-01-02 09:30;30818;596;560;0;0;31974
2022-01-02 10:30;32425;491;560;0;0;33476
2022-01-02 11:30;32941;396;561;0;0;33898
2022-01-02 12:30;32574;457;560;0;0;33591
2022-01-02 13:30;32776;418;561;0;0;33755
2022-01-02 14:30;32701;447;560;0;0;33708
2022-01-02 15:30;33322;509;562;0;0;34393
2022-01-02 16:30;34929;626;561;0;0;36116
2022-01-02 17:30;35783;674;562;0;0;37019
2022-01-02 18:30;35276;792;563;0;0;36631
2022-01-02 19:30;34734;880;563;0;0;36177
2022-01-02 20:30;34152;978;563;0;0;35693
2022-01-02 21:30;33324;1189;562;0;0;35075
2022-01-02 22:30;32281;1397;563;0;0;34241
2022-01-02 23:30;31385;1486;563;0;0;33434
2022-01-03 00:30;31051;1549;563;0;0;33163
2022-01-03 01:30;30972;1589;563;0;0;33124
2022-01-03 02:30;31571;1497;562;0;0;33630
2022-01-03 03:30;31688;1323;563;0;0;33574
2022-01-03 04:30;32311;1402;561;0;0;34274
2022-01-03 05:30;34114;1292;561;0;0;35967
2022-01-03 06:30;35414;1396;562;0;0;37372
2022-01-03 07:30;36838;1292;563;0;0;38693
2022-01-03 08:30;36974;1149;563;0;0;38686
2022-01-03 09:30;36079;1063;562;0;0;37704
2022-01-03 10:30;35622;849;560;0;0;37031
2022-01-03 11:30;35071;801;565;0;0;36437
2022-01-03 12:30;34582;748;558;1;0;35889
2022-01-03 13:30;34134;650;560;1;0;35345
2022-01-03 14:30;34250;600;562;0;0;35412
2022-01-03 15:30;35007;606;561;0;0;36174
2022-01-03 16:30;35661;689;563;0;0;36913
2022-01-03 17:30;36547;746;560;0;0;37853
2022-01-03 18:30;36316;880;561;0;0;37757
2022-01-03 19:30;35633;906;562;0;0;37101
2022-01-03 20:30;35818;823;563;0;0;37204
2022-01-03 21:30;36430;675;562;0;0;37667
2022-01-03 22:30;36274;496;564;0;0;37334
2022-01-03 23:30;35683;446;563;0;0;36692
2022-01-04 00:30;35092;379;563;0;0;36034
2022-01-04 01:30;33820;512;563;0;408;35303
2022-01-04 02:30;33382;754;564;0;410;35110
2022-01-04 03:30;33313;706;564;0;408;34991
2022-01-04 04:30;31550;709;562;0;0;32821
2022-01-04 05:30;32076;921;558;0;403;33958
2022-01-04 06:30;32346;944;560;0;0;33850
2022-01-04 07:30;33982;1047;556;0;0;35585
2022-01-04 08:30;35191;1147;556;0;0;36894
2022-01-04 09:30;35848;1203;556;0;0;37607
2022-01-04 10:30;35729;1122;556;0;0;37407
2022-01-04 11:30;34739;1149;558;0;0;36446
2022-01-04 12:30;34518;1070;559;0;0;36147
2022-01-04 13:30;34387;1065;557;0;195;36204
2022-01-04 14:30;34372;1035;558;0;193;36158
2022-01-04 15:30;34590;1137;563;0;390;36680
2022-01-04 16:30;35051;1283;562;0;98;36994
2022-01-04 17:30;35378;1244;561;0;0;37183
2022-01-04 18:30;34967;1284;560;0;0;36811
2022-01-04 19:30;33317;1257;560;0;0;35134
2022-01-04 20:30;33308;1227;562;0;0;35097
2022-01-04 21:30;33215;1184;559;0;0;34958
2022-01-04 22:30;31163;1142;557;0;0;32862
2022-01-04 23:30;29605;1051;564;0;0;31220
2022-01-05 00:30;28999;978;564;0;0;30541
2022-01-05 01:30;28737;961;561;0;0;30259
2022-01-05 02:30;28856;754;559;0;0;30169
2022-01-05 03:30;29162;740;558;0;0;30460
2022-01-05 04:30;29620;559;557;0;0;30736
2022-01-05 05:30;30618;514;552;0;0;31684
2022-01-05 06:30;32642;504;551;0;0;33697
2022-01-05 07:30;33878;499;552;0;0;34929
2022-01-05 08:30;34279;526;553;0;0;35358
2022-01-05 09:30;33569;558;554;0;0;34681
2022-01-05 10:30;33005;598;551;0;0;34154
2022-01-05 11:30;32311;628;553;1;0;33493
2022-01-05 12:30;31345;653;553;2;0;32553
2022-01-05 13:30;31437;527;554;3;0;32521
2022-01-05 14:30;32062;468;554;0;0;33084
2022-01-05 15:30;32398;472;553;0;0;33423
2022-01-05 16:30;33262;511;552;0;0;34325
2022-01-05 17:30;34299;531;550;0;0;35380
2022-01-05 18:30;33414;454;550;0;0;34418
2022-01-05 19:30;32615;420;552;0;0;33587
2022-01-05 20:30;31577;395;554;0;0;32526
2022-01-05 21:30;30656;331;555;0;0;31542
2022-01-05 22:30;29640;256;556;0;0;30452
2022-01-05 23:30;28576;286;555;0;0;29417
2022-01-06 00:30;27909;347;552;0;0;28808
2022-01-06 01:30;27195;593;553;0;0;28341
2022-01-06 02:30;26464;770;554;0;0;27788
2022-01-06 03:30;26494;1014;555;0;0;28063
2022-01-06 04:30;26855;1079;555;0;0;28489
2022-01-06 05:30;27903;1021;554;0;0;29478
2022-01-06 06:30;30106;1041;553;0;0;31700
2022-01-06 07:30;31979;1060;557;0;0;33596
2022-01-06 08:30;32255;983;562;0;0;33800
2022-01-06 09:30;32000;1000;565;0;0;33565
2022-01-06 10:30;32135;911;566;1;0;33613
2022-01-06 11:30;32394;787;567;0;0;33748
2022-01-06 12:30;32026;755;567;1;0;33349
2022-01-06 13:30;32344;725;521;1;0;33591
2022-01-06 14:30;32280;644;521;0;0;33445
2022-01-06 15:30;32935;595;520;1;0;34051
2022-01-06 16:30;34269;530;521;0;0;35320
2022-01-06 17:30;35385;426;520;0;0;36331
2022-01-06 18:30;34609;402;520;0;0;35531
2022-01-06 19:30;34236;379;521;0;0;35136
2022-01-06 20:30;33983;286;523;0;0;34792
2022-01-06 21:30;33976;123;521;0;0;34620
2022-01-06 22:30;33201;116;523;0;0;33840
2022-01-06 23:30;31815;233;525;0;0;32573
2022-01-07 00:30;31006;137;525;0;0;31668
2022-01-07 01:30;30833;94;524;0;0;31451
2022-01-07 02:30;30745;55;519;0;0;31319
2022-01-07 03:30;30797;50;520;0;0;31367
2022-01-07 04:30;31796;88;521;0;0;32405
2022-01-07 05:30;32666;173;521;0;0;33360
2022-01-07 06:30;33921;214;519;0;0;34654
2022-01-07 07:30;35394;270;519;0;0;36183
2022-01-07 08:30;36018;289;516;0;0;36823
2022-01-07 09:30;35211;232;513;0;0;35956
2022-01-07 10:30;34796;205;517;1;0;35519
2022-01-07 11:30;34378;203;517;1;0;35099
2022-01-07 12:30;34377;176;534;1;0;35088
2022-01-07 13:30;34116;185;534;0;0;34835
2022-01-07 14:30;33909;301;535;0;0;34745
2022-01-07 15:30;34130;418;537;0;0;35085
2022-01-07 16:30;34673;765;536;0;0;35974
2022-01-07 17:30;35378;999;536;0;0;36913
2022-01-07 18:30;34659;1119;538;0;0;36316
2022-01-07 19:30;34263;1246;538;0;0;36047
2022-01-07 20:30;33867;1349;537;0;0;35753
2022-01-07 21:30;33048;1467;535;0;0;35050
2022-01-07 22:30;32542;1499;536;0;0;34577
2022-01-07 23:30;32072;1096;533;0;0;33701
2022-01-08 00:30;31274;1594;535;0;0;33403
2022-01-08 01:30;31240;1766;533;0;0;33539
2022-01-08 02:30;31483;1973;533;0;0;33989
2022-01-08 03:30;31638;1760;531;0;0;33929
2022-01-08 04:30;32592;1680;531;0;0;34803
2022-01-08 05:30;33431;2022;532;0;0;35985
2022-01-08 06:30;34549;1592;532;0;0;36673
2022-01-08 07:30;35773;1913;528;0;0;38214
2022-01-08 08:30;36012;1801;523;0;0;38336
2022-01-08 09:30;35905;1462;526;1;0;37894
2022-01-08 10:30;35215;1218;527;1;0;36961
2022-01-08 11:30;34496;1177;522;2;0;36197
2022-01-08 12:30;33369;1368;522;3;0;35262
2022-01-08 13:30;32879;1323;502;2;0;34706
2022-01-08 14:30;32439;1220;501;1;0;34161
2022-01-08 15:30;33969;1349;503;0;0;35821
2022-01-08 16:30;35286;1699;504;0;0;37489
2022-01-08 17:30;35880;1896;501;0;0;38277
2022-01-08 18:30;35416;1909;501;0;0;37826
2022-01-08 19:30;34705;1744;504;0;0;36953
2022-01-08 20:30;34399;1655;507;0;0;36561
2022-01-08 21:30;33964;1611;508;0;0;36083
2022-01-08 22:30;32439;1576;506;0;0;34521
2022-01-08 23:30;30701;1713;504;0;0;32918
2022-01-09 00:30;30364;1820;503;0;0;32687
2022-01-09 01:30;29727;1973;504;0;0;32204
2022-01-09 02:30;28723;2243;502;0;0;31468
2022-01-09 03:30;28778;2402;501;0;0;31681
2022-01-09 04:30;28453;2326;500;0;0;31279
2022-01-09 05:30;28900;2299;500;0;0;31699
2022-01-09 06:30;29472;2248;499;0;0;32219
2022-01-09 07:30;29607;2315;498;0;0;32420
2022-01-09 08:30;30216;2354;498;0;0;33068
2022-01-09 09:30;30932;2345;497;0;0;33774
2022-01-09 10:30;31572;2372;498;0;0;34442
2022-01-09 11:30;31282;2353;498;0;0;34133
2022-01-09 12:30;31078;2716;497;0;0;34291
2022-01-09 13:30;30608;2609;528;0;0;33745
2022-01-09 14:30;30456;2599;524;0;0;33579
2022-01-09 15:30;30185;2601;525;0;0;33311
2022-01-09 16:30;31124;2398;529;0;0;34051
2022-01-09 17:30;32035;2312;529;0;0;34876
2022-01-09 18:30;30971;2282;528;0;0;33781
2022-01-09 19:30;30217;2192;527;0;0;32936
2022-01-09 20:30;29738;2199;526;0;0;32463
2022-01-09 21:30;28772;2167;527;0;0;31466
2022-01-09 22:30;27798;2022;529;0;0;30349
2022-01-09 23:30;26812;2247;528;0;0;29587
2022-01-10 00:30;26166;2476;526;0;0;29168
2022-01-10 01:30;26110;2122;526;0;0;28758
2022-01-10 02:30;26482;2371;527;0;0;29380
2022-01-10 03:30;26939;2326;527;0;0;29792
2022-01-10 04:30;27922;2221;529;0;0;30672
2022-01-10 05:30;29843;2286;527;0;0;32656
2022-01-10 06:30;32813;2280;527;0;0;35620
2022-01-10 07:30;34860;2276;527;0;0;37663
2022-01-10 08:30;35292;2470;526;0;0;38288
2022-01-10 09:30;34268;2463;526;4;0;37261
2022-01-10 10:30;33567;2434;524;4;0;36529
2022-01-10 11:30;32105;2395;520;4;0;35024
2022-01-10 12:30;31776;2077;533;6;0;34392
2022-01-10 13:30;31688;2418;536;5;0;34647
2022-01-10 14:30;31265;2064;538;3;0;33870
2022-01-10 15:30;32725;2020;539;2;0;35286
2022-01-10 16:30;35461;1962;539;0;0;37962
2022-01-10 17:30;35826;1993;539;0;0;38358
2022-01-10 18:30;35518;2064;544;0;0;38126
2022-01-10 19:30;35101;2186;545;0;0;37832
2022-01-10 20:30;35453;2084;547;0;0;38084
2022-01-10 21:30;35477;2376;545;0;0;38398
2022-01-10 22:30;35023;2096;542;0;0;37661
2022-01-10 23:30;34798;2031;543;0;0;37372
2022-01-11 00:30;34491;2100;544;0;0;37135
2022-01-11 01:30;35172;2270;543;0;0;37985
2022-01-11 02:30;34899;2271;543;0;0;37713
2022-01-11 03:30;34802;2220;542;0;0;37564
2022-01-11 04:30;34898;1820;544;0;0;37262
2022-01-11 05:30;35217;1765;544;0;0;37526
2022-01-11 06:30;34979;2098;543;0;0;37620
2022-01-11 07:30;36509;1799;542;0;0;38850
2022-01-11 08:30;37318;2222;541;1;0;40082
2022-01-11 09:30;36906;2090;536;4;0;39536
2022-01-11 10:30;35942;2028;532;5;0;38507
2022-01-11 11:30;36215;1992;530;8;0;38745
2022-01-11 12:30;35998;1988;524;8;0;38518
2022-01-11 13:30;35799;1635;522;7;0;37963
2022-01-11 14:30;35670;1897;526;5;0;38098
2022-01-11 15:30;35008;1873;525;3;0;37409
2022-01-11 16:30;35750;2028;527;0;0;38305
2022-01-11 17:30;36053;2201;528;0;0;38782
2022-01-11 18:30;35185;1927;531;0;0;37643
2022-01-11 19:30;34637;2034;529;0;0;37200
2022-01-11 20:30;34525;2284;531;0;0;37340
2022-01-11 21:30;34219;2147;531;0;0;36897
2022-01-11 22:30;34284;2010;531;0;0;36825
2022-01-11 23:30;34023;1951;530;0;0;36504
2022-01-12 00:30;34594;1935;531;0;0;37060
2022-01-12 01:30;34662;1940;528;0;0;37130
2022-01-12 02:30;34397;1890;529;0;0;36816
2022-01-12 03:30;33825;2114;528;0;0;36467
2022-01-12 04:30;33929;2301;527;0;0;36757
2022-01-12 05:30;34423;2444;523;0;0;37390
2022-01-12 06:30;35148;2182;522;0;0;37852
2022-01-12 07:30;36251;2225;523;0;0;38999
2022-01-12 08:30;36424;2278;522;0;0;39224
2022-01-12 09:30;36843;2285;522;1;0;39651
2022-01-12 10:30;36149;2134;524;1;0;38808
2022-01-12 11:30;36159;2406;524;1;0;39090
2022-01-12 12:30;36157;2214;528;0;0;38899
2022-01-12 13:30;36316;1957;530;0;294;39097
2022-01-12 14:30;35893;1558;531;0;0;37982
2022-01-12 15:30;36035;1177;533;0;0;37745
2022-01-12 16:30;36075;971;531;0;0;37577
2022-01-12 17:30;35865;760;532;0;0;37157
2022-01-12 18:30;35632;676;537;0;0;36845
2022-01-12 19:30;35489;603;543;0;0;36635
2022-01-12 20:30;35028;587;543;0;0;36158
2022-01-12 21:30;34711;638;543;0;0;35892
2022-01-12 22:30;33939;533;545;0;0;35017
2022-01-12 23:30;31998;434;546;0;0;32978
2022-01-13 00:30;32233;319;542;0;0;33094
2022-01-13 01:30;32278;187;539;0;0;33004
2022-01-13 02:30;32435;114;539;0;0;33088
2022-01-13 03:30;32621;37;539;0;0;33197
2022-01-13 04:30;32662;19;538;0;0;33219
2022-01-13 05:30;34353;40;540;0;0;34933
2022-01-13 06:30;35813;105;540;0;0;36458
2022-01-13 07:30;36677;200;539;0;0;37416
2022-01-13 08:30;37283;212;535;0;0;38030
2022-01-13 09:30;36285;195;535;0;0;37015
2022-01-13 10:30;35347;147;539;0;0;36033
2022-01-13 11:30;35175;179;537;0;0;35891
2022-01-13 12:30;35550;209;540;0;0;36299
2022-01-13 13:30;35797;167;537;0;0;36501
2022-01-13 14:30;35249;181;537;0;0;35967
2022-01-13 15:30;34770;242;532;0;0;35544
2022-01-13 16:30;35285;400;533;0;0;36218
2022-01-13 17:30;36300;715;534;0;0;37549
2022-01-13 18:30;36024;906;538;0;0;37468
2022-01-13 19:30;35736;902;544;0;0;37182
2022-01-13 20:30;34589;985;547;0;0;36121
2022-01-13 21:30;34219;1077;546;0;0;35842
2022-01-13 22:30;32795;1005;546;0;0;34346
2022-01-13 23:30;31539;986;545;0;0;33070
2022-01-14 00:30;30249;900;546;0;0;31695
2022-01-14 01:30;30125;833;546;0;0;31504
2022-01-14 02:30;30185;711;545;0;0;31441
2022-01-14 03:30;30002;670;545;0;0;31217
2022-01-14 04:30;30577;603;543;0;0;31723
2022-01-14 05:30;31417;549;542;0;0;32508
2022-01-14 06:30;32697;539;539;0;0;33775
2022-01-14 07:30;34252;489;537;0;0;35278
2022-01-14 08:30;34456;484;536;0;0;35476
2022-01-14 09:30;34172;618;535;0;0;35325
2022-01-14 10:30;33157;728;533;0;0;34418
2022-01-14 11:30;32699;795;533;1;0;34028
2022-01-14 12:30;31988;934;525;1;0;33448
2022-01-14 13:30;31783;1103;533;1;0;33420
2022-01-14 14:30;31602;1350;538;0;0;33490
2022-01-14 15:30;32276;1741;536;0;0;34553
2022-01-14 16:30;33579;1655;535;0;0;35769
2022-01-14 17:30;34991;1852;538;0;0;37381
2022-01-14 18:30;34772;2270;541;0;0;37583
2022-01-14 19:30;35134;2001;540;0;0;37675
2022-01-14 20:30;34977;2039;536;0;0;37552
2022-01-14 21:30;34226;2039;534;0;0;36799
2022-01-14 22:30;34960;2048;538;0;0;37546
2022-01-14 23:30;34231;2025;539;0;0;36795
2022-01-15 00:30;33829;1964;539;0;0;36332
2022-01-15 01:30;33376;1941;539;0;0;35856
2022-01-15 02:30;33191;1976;538;0;0;35705
2022-01-15 03:30;33280;1982;538;0;0;35800
2022-01-15 04:30;34106;2006;539;0;0;36651
2022-01-15 05:30;34993;1991;538;0;0;37522
2022-01-15 06:30;36325;1965;538;0;0;38828
2022-01-15 07:30;36607;2002;538;0;0;39147
2022-01-15 08:30;36559;2031;539;0;0;39129
2022-01-15 09:30;36683;2015;539;1;0;39238
2022-01-15 10:30;35385;1998;537;1;0;37921
2022-01-15 11:30;35587;2093;534;1;0;38215
2022-01-15 12:30;35676;2265;534;1;0;38476
2022-01-15 13:30;35842;2322;536;1;0;38701
2022-01-15 14:30;35414;2378;535;1;0;38328
2022-01-15 15:30;35001;2384;537;0;0;37922
2022-01-15 16:30;36751;2443;539;0;0;39733
2022-01-15 17:30;37147;2467;539;0;403;40556
2022-01-15 18:30;35805;2325;539;0;405;39074
2022-01-15 19:30;35687;2235;539;0;216;38677
2022-01-15 20:30;36026;2209;539;0;0;38774
2022-01-15 21:30;36105;2194;533;0;0;38832
2022-01-15 22:30;35107;2104;533;0;0;37744
2022-01-15 23:30;33271;1956;531;0;0;35758
2022-01-16 00:30;33416;2510;531;0;0;36457
2022-01-16 01:30;33449;2611;531;0;0;36591
2022-01-16 02:30;33851;2706;531;0;0;37088
2022-01-16 03:30;33985;2311;531;0;0;36827
2022-01-16 04:30;34090;2277;531;0;0;36898
2022-01-16 05:30;34467;2209;531;0;0;37207
2022-01-16 06:30;34962;2065;530;0;0;37557
2022-01-16 07:30;35670;2070;531;0;0;38271
2022-01-16 08:30;35638;2450;535;0;0;38623
2022-01-16 09:30;34837;2176;535;1;0;37549
2022-01-16 10:30;34293;1880;535;1;0;36709
2022-01-16 11:30;33648;1718;535;1;0;35902
2022-01-16 12:30;33111;1664;529;1;0;35305
2022-01-16 13:30;33476;1530;528;1;0;35535
2022-01-16 14:30;34833;1534;529;1;0;36897
2022-01-16 15:30;33890;1623;531;0;0;36044
2022-01-16 16:30;34940;1832;533;0;0;37305
2022-01-16 17:30;36246;2035;536;0;0;38817
2022-01-16 18:30;35582;2212;535;0;0;38329
2022-01-16 19:30;35465;2273;534;0;0;38272
2022-01-16 20:30;34796;2312;533;0;0;37641
2022-01-16 21:30;34047;1968;532;0;0;36547
2022-01-16 22:30;33851;2218;533;0;0;36602
2022-01-16 23:30;31614;2268;533;0;0;34415
2022-01-17 00:30;31654;1916;533;0;0;34103
2022-01-17 01:30;31591;2272;533;0;0;34396
2022-01-17 02:30;31140;2246;534;0;0;33920
2022-01-17 03:30;30851;2226;533;0;0;33610
2022-01-17 04:30;32458;2212;532;0;0;35202
2022-01-17 05:30;33637;2184;531;0;0;36352
2022-01-17 06:30;33293;2119;532;0;0;35944
2022-01-17 07:30;34192;2074;531;0;0;36797
2022-01-17 08:30;34077;2376;530;0;0;36983
2022-01-17 09:30;34812;2715;530;0;0;38057
2022-01-17 10:30;34539;2793;527;0;0;37859
2022-01-17 11:30;34599;2386;527;0;0;37512
2022-01-17 12:30;35234;2654;521;0;0;38409
2022-01-17 13:30;34521;2459;524;0;0;37504
2022-01-17 14:30;33887;2477;527;0;0;36891
2022-01-17 15:30;33327;2654;528;0;0;36509
2022-01-17 16:30;33955;2708;531;0;0;37194
2022-01-17 17:30;34639;2388;534;0;0;37561
2022-01-17 18:30;34654;2057;533;0;0;37244
2022-01-17 19:30;34128;2004;532;0;0;36664
2022-01-17 20:30;33224;1968;532;0;0;35724
2022-01-17 21:30;32022;1889;533;0;0;34444
2022-01-17 22:30;30711;2369;533;0;0;33613
2022-01-17 23:30;29597;2145;533;0;0;32275
2022-01-18 00:30;29324;2102;531;0;0;31957
2022-01-18 01:30;29284;2110;529;0;0;31923
2022-01-18 02:30;28550;2409;528;0;0;31487
2022-01-18 03:30;28946;2553;528;0;0;32027
2022-01-18 04:30;29421;2718;526;0;0;32665
2022-01-18 05:30;31301;2326;524;0;0;34151
2022-01-18 06:30;33811;2383;524;0;0;36718
2022-01-18 07:30;35852;2375;524;0;0;38751
2022-01-18 08:30;35391;2493;526;0;0;38410
2022-01-18 09:30;34292;2696;524;0;0;37512
2022-01-18 10:30;33316;2381;515;0;0;36212
2022-01-18 11:30;32656;2587;518;1;0;35762
2022-01-18 12:30;31775;2677;522;1;0;34975
2022-01-18 13:30;31809;2745;522;1;0;35077
2022-01-18 14:30;31907;2791;522;1;0;35221
2022-01-18 15:30;33142;2933;521;0;0;36596
2022-01-18 16:30;34443;2829;521;0;0;37793
2022-01-18 17:30;36303;2709;524;0;0;39536
2022-01-18 18:30;36131;2760;528;0;0;39419
2022-01-18 19:30;35778;2643;526;0;0;38947
2022-01-18 20:30;35255;2489;523;0;0;38267
2022-01-18 21:30;35207;2406;526;0;0;38139
2022-01-18 22:30;34351;2364;527;0;0;37242
2022-01-18 23:30;32011;2177;528;0;0;34716
2022-01-19 00:30;32577;1903;526;0;0;35006
2022-01-19 01:30;32047;1789;524;0;0;34360
2022-01-19 02:30;32150;1726;525;0;0;34401
2022-01-19 03:30;32191;1539;523;0;0;34253
2022-01-19 04:30;32546;1396;524;0;0;34466
2022-01-19 05:30;34272;1272;523;0;0;36067
2022-01-19 06:30;34851;1373;519;0;0;36743
2022-01-19 07:30;35537;1321;517;0;0;37375
2022-01-19 08:30;35942;1296;517;0;0;37755
2022-01-19 09:30;36248;1335;517;0;0;38100
2022-01-19 10:30;36556;1170;522;0;0;38248
2022-01-19 11:30;36658;1060;524;0;0;38242
2022-01-19 12:30;36448;1016;529;0;296;38289
2022-01-19 13:30;36587;920;530;0;198;38235
2022-01-19 14:30;35121;1010;531;0;0;36662
2022-01-19 15:30;34926;1126;533;0;0;36585
2022-01-19 16:30;35026;1283;530;0;0;36839
2022-01-19 17:30;35725;1406;529;0;0;37660
2022-01-19 18:30;35747;1554;527;0;0;37828
2022-01-19 19:30;35049;1742;528;0;0;37319
2022-01-19 20:30;34151;1809;532;0;0;36492
2022-01-19 21:30;32961;1634;532;0;0;35127
2022-01-19 22:30;32572;1599;526;0;0;34697
2022-01-19 23:30;30320;1612;523;0;0;32455
2022-01-20 00:30;30604;1692;525;0;0;32821
2022-01-20 01:30;30378;1661;525;0;0;32564
2022-01-20 02:30;30462;1732;527;0;0;32721
2022-01-20 03:30;29052;1798;527;0;389;31766
2022-01-20 04:30;31369;2005;525;0;0;33899
2022-01-20 05:30;33057;1977;525;0;0;35559
2022-01-20 06:30;34495;2138;525;0;0;37158
2022-01-20 07:30;35715;2227;525;0;0;38467
2022-01-20 08:30;36074;2003;524;0;0;38601
2022-01-20 09:30;35353;1632;520;0;0;37505
2022-01-20 10:30;33955;1651;505;1;0;36112
2022-01-20 11:30;33829;1785;503;1;0;36118
2022-01-20 12:30;33519;1840;513;1;0;35873
2022-01-20 13:30;33095;1888;518;1;0;35502
2022-01-20 14:30;32813;1886;522;0;0;35221
2022-01-20 15:30;33186;1883;523;0;0;35592
2022-01-20 16:30;34399;1823;527;0;0;36749
2022-01-20 17:30;36497;2052;523;0;0;39072
2022-01-20 18:30;35811;2111;524;0;0;38446
2022-01-20 19:30;35805;2019;522;0;0;38346
2022-01-20 20:30;35388;2006;520;0;0;37914
2022-01-20 21:30;35536;1810;520;0;0;37866
2022-01-20 22:30;34063;1809;523;0;0;36395
2022-01-20 23:30;32053;1930;523;0;0;34506
2022-01-21 00:30;31374;1819;526;0;0;33719
2022-01-21 01:30;31675;1873;526;0;0;34074
2022-01-21 02:30;32214;1817;526;0;0;34557
2022-01-21 03:30;33032;1720;525;0;0;35277
2022-01-21 04:30;33215;1645;526;0;0;35386
2022-01-21 05:30;34322;1587;525;0;0;36434
2022-01-21 06:30;34553;1606;525;0;0;36684
2022-01-21 07:30;36059;1474;525;0;0;38058
2022-01-21 08:30;36512;1355;526;0;0;38393
2022-01-21 09:30;35601;1061;525;0;0;37187
2022-01-21 10:30;34087;902;526;1;0;35516
2022-01-21 11:30;33277;780;525;1;0;34583
2022-01-21 12:30;34387;685;528;1;0;35601
2022-01-21 13:30;34985;545;528;1;0;36059
2022-01-21 14:30;35043;548;529;0;0;36120
2022-01-21 15:30;34104;604;528;0;0;35236
2022-01-21 16:30;34713;843;528;0;0;36084
2022-01-21 17:30;36089;1180;529;0;0;37798
2022-01-21 18:30;35683;1222;530;0;0;37435
2022-01-21 19:30;35326;1243;533;0;0;37102
2022-01-21 20:30;35080;1301;533;0;0;36914
2022-01-21 21:30;34781;1368;532;0;0;36681
2022-01-21 22:30;35304;1235;532;0;0;37071
2022-01-21 23:30;35085;1134;533;0;0;36752
2022-01-22 00:30;34154;1058;534;0;0;35746
2022-01-22 01:30;35027;1098;534;0;0;36659
2022-01-22 02:30;34585;991;533;0;0;36109
2022-01-22 03:30;34818;954;533;0;0;36305
2022-01-22 04:30;34753;892;529;0;0;36174
2022-01-22 05:30;34266;799;531;0;0;35596
2022-01-22 06:30;35614;751;532;0;0;36897
2022-01-22 07:30;36385;769;530;0;0;37684
2022-01-22 08:30;36297;750;530;0;0;37577
2022-01-22 09:30;35895;630;525;0;0;37050
2022-01-22 10:30;34818;496;522;1;0;35837
2022-01-22 11:30;34746;473;525;1;0;35745
2022-01-22 12:30;34660;514;527;1;0;35702
2022-01-22 13:30;34879;504;528;1;0;35912
2022-01-22 14:30;35651;601;528;1;0;36781
2022-01-22 15:30;35766;635;526;0;0;36927
2022-01-22 16:30;35390;1028;529;0;0;36947
2022-01-22 17:30;35923;1539;532;0;0;37994
2022-01-22 18:30;35038;2044;534;0;0;37616
2022-01-22 19:30;33810;2408;532;0;0;36750
2022-01-22 20:30;33662;2412;530;0;0;36604
2022-01-22 21:30;33680;2351;531;0;0;36562
2022-01-22 22:30;32505;2271;531;0;0;35307
2022-01-22 23:30;32263;2276;531;0;0;35070
2022-01-23 00:30;31812;2420;530;0;0;34762
2022-01-23 01:30;31373;2459;529;0;0;34361
2022-01-23 02:30;30670;2476;529;0;0;33675
2022-01-23 03:30;31111;2605;528;0;0;34244
2022-01-23 04:30;31285;2593;528;0;0;34406
2022-01-23 05:30;31927;2703;529;0;0;35159
2022-01-23 06:30;32670;2638;528;0;0;35836
2022-01-23 07:30;33766;2534;526;0;0;36826
2022-01-23 08:30;34349;2427;525;0;0;37301
2022-01-23 09:30;34143;2234;527;0;0;36904
2022-01-23 10:30;33628;1966;527;1;0;36122
2022-01-23 11:30;32557;1968;527;1;0;35053
2022-01-23 12:30;31768;1902;527;1;0;34198
2022-01-23 13:30;31201;1926;526;0;0;33653
2022-01-23 14:30;30387;1749;529;1;0;32666
2022-01-23 15:30;31144;1728;525;0;0;33397
2022-01-23 16:30;33412;1627;524;0;0;35563
2022-01-23 17:30;35600;1820;525;0;0;37945
2022-01-23 18:30;35409;1944;526;0;0;37879
2022-01-23 19:30;35106;1763;523;0;0;37392
2022-01-23 20:30;35016;1582;523;0;0;37121
2022-01-23 21:30;34741;1421;520;0;0;36682
2022-01-23 22:30;33986;1158;513;0;0;35657
2022-01-23 23:30;33428;930;511;0;0;34869
2022-01-24 00:30;32460;913;514;0;0;33887
2022-01-24 01:30;33163;794;514;0;0;34471
2022-01-24 02:30;33640;751;515;0;0;34906
2022-01-24 03:30;33973;775;515;0;0;35263
2022-01-24 04:30;34902;672;513;0;0;36087
2022-01-24 05:30;35077;515;514;0;0;36106
2022-01-24 06:30;35238;495;518;0;0;36251
2022-01-24 07:30;37067;532;519;0;0;38118
2022-01-24 08:30;36571;521;520;0;0;37612
2022-01-24 09:30;36230;300;519;0;0;37049
2022-01-24 10:30;34719;293;515;1;0;35528
2022-01-24 11:30;34816;275;518;1;0;35610
2022-01-24 12:30;35183;277;521;1;0;35982
2022-01-24 13:30;35201;251;524;1;0;35977
2022-01-24 14:30;35011;267;520;1;0;35799
2022-01-24 15:30;34894;136;522;0;0;35552
2022-01-24 16:30;35627;167;525;0;0;36319
2022-01-24 17:30;36369;385;524;0;0;37278
2022-01-24 18:30;35605;497;525;0;0;36627
2022-01-24 19:30;35686;621;528;0;0;36835
2022-01-24 20:30;34708;777;529;0;0;36014
2022-01-24 21:30;33955;786;530;0;0;35271
2022-01-24 22:30;34146;939;530;0;0;35615
2022-01-24 23:30;32543;1002;533;0;0;34078
2022-01-25 00:30;32922;1014;529;0;0;34465
2022-01-25 01:30;32969;847;531;0;0;34347
2022-01-25 02:30;32670;706;528;0;0;33904
2022-01-25 03:30;32809;593;526;0;0;33928
2022-01-25 04:30;33489;642;528;0;0;34659
2022-01-25 05:30;33796;561;530;0;0;34887
2022-01-25 06:30;34682;565;527;0;0;35774
2022-01-25 07:30;35813;909;526;0;0;37248
2022-01-25 08:30;35790;1073;525;0;197;37585
2022-01-25 09:30;35602;953;516;0;0;37071
2022-01-25 10:30;34653;864;510;0;0;36027
2022-01-25 11:30;34333;677;510;1;0;35521
2022-01-25 12:30;34044;492;512;1;0;35049
2022-01-25 13:30;32978;428;512;1;0;33919
2022-01-25 14:30;33370;360;514;0;0;34244
2022-01-25 15:30;33326;348;514;0;0;34188
2022-01-25 16:30;34804;399;511;0;0;35714
2022-01-25 17:30;36696;428;512;0;0;37636
2022-01-25 18:30;36367;557;513;0;0;37437
2022-01-25 19:30;35589;822;516;0;0;36927
2022-01-25 20:30;34869;1107;516;0;0;36492
2022-01-25 21:30;34826;1074;517;0;0;36417
2022-01-25 22:30;34196;1188;517;0;0;35901
2022-01-25 23:30;32538;1358;516;0;0;34412
2022-01-26 00:30;31830;1476;517;0;0;33823
2022-01-26 01:30;31931;1411;519;0;0;33861
2022-01-26 02:30;32088;1374;521;0;0;33983
2022-01-26 03:30;31878;1533;527;0;0;33938
2022-01-26 04:30;33623;1382;529;0;0;35534
2022-01-26 05:30;34801;1426;525;0;0;36752
2022-01-26 06:30;35350;1306;519;0;0;37175
2022-01-26 07:30;36652;1456;521;0;0;38629
2022-01-26 08:30;36280;1381;521;0;0;38182
2022-01-26 09:30;36386;1135;522;0;0;38043
2022-01-26 10:30;35234;1012;520;1;0;36767
2022-01-26 11:30;34941;1104;525;1;0;36571
2022-01-26 12:30;34513;1087;524;1;0;36125
2022-01-26 13:30;34900;1135;527;1;0;36563
2022-01-26 14:30;34261;1123;527;1;0;35912
2022-01-26 15:30;34195;1144;527;0;0;35866
2022-01-26 16:30;34494;1229;528;0;0;36251
2022-01-26 17:30;35789;1447;526;0;0;37762
2022-01-26 18:30;36181;1428;530;0;0;38139
2022-01-26 19:30;35622;1364;526;0;0;37512
2022-01-26 20:30;36203;1174;526;0;0;37903
2022-01-26 21:30;35236;1092;529;0;0;36857
2022-01-26 22:30;35562;932;529;0;0;37023
2022-01-26 23:30;34427;1063;535;0;0;36025
2022-01-27 00:30;34447;1101;535;0;0;36083
2022-01-27 01:30;34682;1185;534;0;0;36401
2022-01-27 02:30;34613;1318;537;0;0;36468
2022-01-27 03:30;34909;1410;538;0;0;36857
2022-01-27 04:30;35590;1583;537;0;0;37710
2022-01-27 05:30;35717;1736;538;0;0;37991
2022-01-27 06:30;35001;1926;536;0;0;37463
2022-01-27 07:30;35751;2141;536;0;0;38428
2022-01-27 08:30;36206;2395;537;0;0;39138
2022-01-27 09:30;36203;2205;537;0;0;38945
2022-01-27 10:30;35144;2114;536;1;0;37795
2022-01-27 11:30;35456;2164;536;1;0;38157
2022-01-27 12:30;36246;2187;518;1;0;38952
2022-01-27 13:30;35479;2207;518;1;0;38205
2022-01-27 14:30;34436;2434;512;1;0;37383
2022-01-27 15:30;34157;2673;510;0;0;37340
2022-01-27 16:30;35119;2861;509;0;0;38489
2022-01-27 17:30;35810;2607;511;0;0;38928
2022-01-27 18:30;35030;2579;513;0;0;38122
2022-01-27 19:30;34282;2579;513;0;0;37374
2022-01-27 20:30;34026;2642;510;0;0;37178
2022-01-27 21:30;33638;2623;509;0;0;36770
2022-01-27 22:30;32164;2905;510;0;0;35579
2022-01-27 23:30;30489;2638;507;0;0;33634
2022-01-28 00:30;30435;2383;510;0;0;33328
2022-01-28 01:30;30105;2196;509;0;0;32810
2022-01-28 02:30;30319;2009;510;0;0;32838
2022-01-28 03:30;30659;1786;510;0;0;32955
2022-01-28 04:30;30688;1542;511;0;0;32741
2022-01-28 05:30;32359;1314;511;0;0;34184
2022-01-28 06:30;35121;1152;512;0;0;36785
2022-01-28 07:30;37064;1071;511;0;333;38979
2022-01-28 08:30;36742;959;512;0;418;38631
2022-01-28 09:30;36245;875;510;0;110;37740
2022-01-28 10:30;34680;715;506;1;0;35902
2022-01-28 11:30;34390;773;510;1;0;35674
2022-01-28 12:30;33765;818;500;1;0;35084
2022-01-28 13:30;33243;756;499;1;0;34499
2022-01-28 14:30;33048;676;501;1;0;34226
2022-01-28 15:30;33350;641;501;0;0;34492
2022-01-28 16:30;35149;689;501;0;0;36339
2022-01-28 17:30;36937;828;499;0;0;38264
2022-01-28 18:30;36732;899;499;0;0;38130
2022-01-28 19:30;36436;956;502;0;0;37894
2022-01-28 20:30;36748;951;505;0;0;38204
2022-01-28 21:30;36112;890;505;0;0;37507
2022-01-28 22:30;35363;943;504;0;0;36810
2022-01-28 23:30;33442;1003;502;0;0;34947
2022-01-29 00:30;33431;842;503;0;0;34776
2022-01-29 01:30;34064;734;502;0;0;35300
2022-01-29 02:30;34248;869;503;0;0;35620
2022-01-29 03:30;33999;1420;503;0;0;35922
2022-01-29 04:30;34197;1349;501;0;0;36047
2022-01-29 05:30;35407;1032;502;0;0;36941
2022-01-29 06:30;35606;1398;501;0;0;37505
2022-01-29 07:30;35954;1754;502;0;0;38210
2022-01-29 08:30;36739;1789;504;0;0;39032
2022-01-29 09:30;36105;1664;502;0;204;38475
2022-01-29 10:30;34425;1757;501;1;0;36684
2022-01-29 11:30;34176;1869;501;1;0;36547
2022-01-29 12:30;34145;2268;498;1;0;36912
2022-01-29 13:30;34044;2731;497;1;0;37273
2022-01-29 14:30;34466;2794;498;0;0;37758
2022-01-29 15:30;34002;2556;501;0;0;37059
2022-01-29 16:30;33952;2599;502;0;0;37053
2022-01-29 17:30;34901;2989;504;0;0;38394
2022-01-29 18:30;34460;2682;507;0;0;37649
2022-01-29 19:30;34184;2705;509;0;0;37398
2022-01-29 20:30;33902;2550;510;0;0;36962
2022-01-29 21:30;33971;2572;510;0;0;37053
2022-01-29 22:30;33136;2575;513;0;0;36224
2022-01-29 23:30;30864;2561;510;0;0;33935
2022-01-30 00:30;30328;2535;511;0;0;33374
2022-01-30 01:30;30604;2486;512;0;0;33602
2022-01-30 02:30;30680;2441;508;0;0;33629
2022-01-30 03:30;30691;2433;508;0;0;33632
2022-01-30 04:30;31484;2482;508;0;0;34474
2022-01-30 05:30;33385;2615;507;0;0;36507
2022-01-30 06:30;34615;2559;508;0;0;37682
2022-01-30 07:30;35351;2529;508;0;0;38388
2022-01-30 08:30;35013;2477;508;0;0;37998
2022-01-30 09:30;34218;2627;510;0;0;37355
2022-01-30 10:30;32792;2669;505;1;0;35967
2022-01-30 11:30;31975;2752;504;1;0;35232
2022-01-30 12:30;31104;2779;512;1;0;34396
2022-01-30 13:30;30308;2735;509;1;0;33553
2022-01-30 14:30;29981;2757;514;1;0;33253
2022-01-30 15:30;30958;2654;517;0;0;34129
2022-01-30 16:30;32466;2535;513;0;0;35514
2022-01-30 17:30;34733;2627;512;0;0;37872
2022-01-30 18:30;34278;2679;511;0;0;37468
2022-01-30 19:30;34460;2632;510;0;0;37602
2022-01-30 20:30;34070;2542;509;0;0;37121
2022-01-30 21:30;33326;2806;509;0;0;36641
2022-01-30 22:30;32437;2172;510;0;0;35119
2022-01-30 23:30;31837;2138;509;0;0;34484
2022-01-31 00:30;30947;1964;509;0;0;33420
2022-01-31 01:30;30889;1808;509;0;0;33206
2022-01-31 02:30;30931;1714;507;0;0;33152
2022-01-31 03:30;31410;1968;508;0;0;33886
2022-01-31 04:30;32273;1852;504;0;0;34629
2022-01-31 05:30;34172;1835;500;0;0;36507
2022-01-31 06:30;34736;1771;501;0;0;37008
2022-01-31 07:30;35762;1572;500;0;0;37834
2022-01-31 08:30;35531;1305;499;0;0;37335
2022-01-31 09:30;34382;1148;498;0;0;36028
2022-01-31 10:30;33155;1196;496;1;0;34848
2022-01-31 11:30;32642;1214;497;1;0;34354
2022-01-31 12:30;32590;1202;497;3;0;34292
2022-01-31 13:30;32195;1229;499;3;0;33926
2022-01-31 14:30;31856;1225;500;1;0;33582
2022-01-31 15:30;32646;1091;500;2;0;34239
2022-01-31 16:30;34146;1242;491;0;0;35879
2022-01-31 17:30;35378;1510;492;0;0;37380
2022-01-31 18:30;35012;1731;493;0;0;37236
2022-01-31 19:30;34481;1748;494;0;0;36723
2022-01-31 20:30;34501;1552;497;0;0;36550
2022-01-31 21:30;34127;1450;506;0;0;36083
2022-01-31 22:30;34238;1268;513;0;0;36019
2022-01-31 23:30;32663;1135;511;0;0;34309
2022-02-01 00:30;32721;1044;510;0;0;34275
2022-02-01 01:30;33147;920;510;0;0;34577
2022-02-01 02:30;33342;841;503;0;0;34686
2022-02-01 03:30;34077;780;502;0;0;35359
2022-02-01 04:30;34170;872;502;0;0;35544
2022-02-01 05:30;35594;715;501;0;0;36810
2022-02-01 06:30;36255;685;501;0;0;37441
2022-02-01 07:30;36821;620;502;0;409;38352
2022-02-01 08:30;36495;529;503;1;407;37935
2022-02-01 09:30;35449;411;504;2;0;36366
2022-02-01 10:30;34777;277;499;3;0;35556
2022-02-01 11:30;33870;296;500;4;0;34670
2022-02-01 12:30;33909;282;510;4;0;34705
2022-02-01 13:30;32672;360;511;4;0;33547
2022-02-01 14:30;31956;426;510;3;0;32895
2022-02-01 15:30;33245;521;510;2;0;34278
2022-02-01 16:30;33900;1089;511;0;0;35500
2022-02-01 17:30;35172;1657;511;0;0;37340
2022-02-01 18:30;34577;2110;512;0;0;37199
2022-02-01 19:30;33427;2481;513;0;0;36421
2022-02-01 20:30;31605;2927;514;0;0;35046
2022-02-01 21:30;30438;2659;509;0;0;33606
2022-02-01 22:30;28891;2690;507;0;0;32088
2022-02-01 23:30;27254;2638;508;0;0;30400
2022-02-02 00:30;27625;2569;508;0;0;30702
2022-02-02 01:30;26927;2545;507;0;0;29979
2022-02-02 02:30;26352;2618;507;0;0;29477
2022-02-02 03:30;26278;2593;506;0;0;29377
2022-02-02 04:30;26536;2588;506;0;0;29630
2022-02-02 05:30;27751;2515;504;0;0;30770
2022-02-02 06:30;29724;2569;506;0;0;32799
2022-02-02 07:30;31341;2695;505;0;0;34541
2022-02-02 08:30;31312;2673;506;0;0;34491
2022-02-02 09:30;30592;2588;506;3;0;33689
2022-02-02 10:30;29681;2497;506;2;0;32686
2022-02-02 11:30;29286;2271;505;3;0;32065
2022-02-02 12:30;28368;2101;499;5;0;30973
2022-02-02 13:30;27979;2338;502;8;0;30827
2022-02-02 14:30;27911;2158;501;4;0;30574
2022-02-02 15:30;28716;2224;502;1;0;31443
2022-02-02 16:30;29851;1936;502;0;0;32289
2022-02-02 17:30;31056;2080;503;0;0;33639
2022-02-02 18:30;30439;2268;503;0;0;33210
2022-02-02 19:30;29437;2336;504;0;0;32277
2022-02-02 20:30;28957;2271;509;0;0;31737
2022-02-02 21:30;27920;2642;507;0;0;31069
2022-02-02 22:30;25808;2197;505;0;0;28510
2022-02-02 23:30;23763;2588;505;0;0;26856
2022-02-03 00:30;24122;2386;505;0;0;27013
2022-02-03 01:30;23773;2277;506;0;0;26556
2022-02-03 02:30;24034;2063;506;0;0;26603
2022-02-03 03:30;24279;1824;505;0;0;26608
2022-02-03 04:30;24788;1626;505;0;0;26919
2022-02-03 05:30;27103;1419;505;0;0;29027
2022-02-03 06:30;29910;1378;505;0;0;31793
2022-02-03 07:30;32147;1225;505;0;0;33877
2022-02-03 08:30;32862;1233;506;0;0;34601
2022-02-03 09:30;32469;1357;505;0;0;34331
2022-02-03 10:30;31568;1682;504;1;0;33755
2022-02-03 11:30;31196;1532;505;2;0;33235
2022-02-03 12:30;31169;1403;507;2;0;33081
2022-02-03 13:30;31473;1456;504;2;0;33435
2022-02-03 14:30;32130;1263;506;1;0;33900
2022-02-03 15:30;32835;1148;506;1;0;34490
2022-02-03 16:30;33798;1203;506;0;0;35507
2022-02-03 17:30;35605;1288;506;0;0;37399
2022-02-03 18:30;34575;1135;505;0;0;36215
2022-02-03 19:30;34788;1020;506;0;0;36314
2022-02-03 20:30;34690;854;508;0;0;36052
2022-02-03 21:30;34329;738;507;0;0;35574
2022-02-03 22:30;33664;856;508;0;0;35028
2022-02-03 23:30;30926;902;507;0;0;32335
2022-02-04 00:30;31510;821;508;0;0;32839
2022-02-04 01:30;30622;751;500;0;0;31873
2022-02-04 02:30;31025;713;499;0;0;32237
2022-02-04 03:30;31075;775;500;0;0;32350
2022-02-04 04:30;31596;869;501;0;0;32966
2022-02-04 05:30;33585;942;499;0;0;35026
2022-02-04 06:30;33643;1071;497;0;0;35211
2022-02-04 07:30;35828;1118;495;0;0;37441
2022-02-04 08:30;36092;1036;495;0;397;38020
2022-02-04 09:30;35359;1043;492;0;0;36894
2022-02-04 10:30;35075;1008;497;1;0;36581
2022-02-04 11:30;34564;948;501;1;0;36014
2022-02-04 12:30;34677;830;499;1;0;36007
2022-02-04 13:30;34975;872;495;1;0;36343
2022-02-04 14:30;34829;878;498;0;0;36205
2022-02-04 15:30;34996;879;501;0;0;36376
2022-02-04 16:30;35325;926;498;0;0;36749
2022-02-04 17:30;36536;888;498;0;0;37922
2022-02-04 18:30;35529;1033;495;0;0;37057
2022-02-04 19:30;35266;948;491;0;0;36705
2022-02-04 20:30;35068;933;492;0;0;36493
2022-02-04 21:30;33664;823;488;0;0;34975
2022-02-04 22:30;32357;746;488;0;0;33591
2022-02-04 23:30;31511;567;487;0;0;32565
2022-02-05 00:30;32197;423;488;0;0;33108
2022-02-05 01:30;32413;386;486;0;0;33285
2022-02-05 02:30;32477;338;487;0;0;33302
2022-02-05 03:30;32158;343;487;0;0;32988
2022-02-05 04:30;33195;206;491;0;0;33892
2022-02-05 05:30;34117;219;489;0;0;34825
2022-02-05 06:30;35065;269;488;0;0;35822
2022-02-05 07:30;36059;338;490;0;0;36887
2022-02-05 08:30;36420;407;492;0;0;37319
2022-02-05 09:30;35461;497;493;1;0;36452
2022-02-05 10:30;33755;630;492;1;0;34878
2022-02-05 11:30;32928;889;494;2;0;34313
2022-02-05 12:30;31734;1220;482;2;0;33438
2022-02-05 13:30;31448;1632;480;3;0;33563
2022-02-05 14:30;30998;1989;479;3;0;33469
2022-02-05 15:30;31039;2275;477;1;0;33792
2022-02-05 16:30;32086;2491;478;0;0;35055
2022-02-05 17:30;34661;2807;481;0;0;37949
2022-02-05 18:30;34833;2432;482;0;0;37747
2022-02-05 19:30;34643;2820;484;0;0;37947
2022-02-05 20:30;34358;2433;485;0;0;37276
2022-02-05 21:30;34260;2295;485;0;0;37040
2022-02-05 22:30;34048;2241;484;0;0;36773
2022-02-05 23:30;32345;2030;483;0;0;34858
2022-02-06 00:30;32286;2034;481;0;0;34801
2022-02-06 01:30;32343;1773;483;0;0;34599
2022-02-06 02:30;32259;1636;483;0;0;34378
2022-02-06 03:30;32470;1382;483;0;0;34335
2022-02-06 04:30;33016;1339;482;0;0;34837
2022-02-06 05:30;34207;1347;482;0;0;36036
2022-02-06 06:30;34535;1278;483;0;0;36296
2022-02-06 07:30;35099;1150;486;0;0;36735
2022-02-06 08:30;35348;903;490;0;0;36741
2022-02-06 09:30;35651;697;493;1;0;36842
2022-02-06 10:30;35900;403;493;1;0;36797
2022-02-06 11:30;35937;227;494;2;0;36660
2022-02-06 12:30;35387;290;493;2;0;36172
2022-02-06 13:30;35252;317;493;2;0;36064
2022-02-06 14:30;34898;560;497;1;0;35956
2022-02-06 15:30;35263;793;495;1;0;36552
2022-02-06 16:30;35230;1248;497;0;0;36975
2022-02-06 17:30;35700;1639;495;0;0;37834
2022-02-06 18:30;35232;1963;498;0;394;38087
2022-02-06 19:30;34490;2289;496;0;0;37275
2022-02-06 20:30;33589;2420;494;0;0;36503
2022-02-06 21:30;32499;2509;498;0;0;35506
2022-02-06 22:30;31111;2512;497;0;0;34120
2022-02-06 23:30;30062;2394;498;0;0;32954
2022-02-07 00:30;29969;2204;497;0;0;32670
2022-02-07 01:30;29835;1988;497;0;0;32320
2022-02-07 02:30;30080;1871;496;0;0;32447
2022-02-07 03:30;30308;1801;494;0;0;32603
2022-02-07 04:30;30898;1663;492;0;0;33053
2022-02-07 05:30;32587;1397;494;0;0;34478
2022-02-07 06:30;34517;1199;494;0;0;36210
2022-02-07 07:30;35953;1027;496;0;0;37476
2022-02-07 08:30;35774;837;496;1;0;37108
2022-02-07 09:30;34311;580;495;1;0;35387
2022-02-07 10:30;33049;363;495;3;0;33910
2022-02-07 11:30;32824;215;494;3;0;33536
2022-02-07 12:30;32586;117;494;3;0;33200
2022-02-07 13:30;33109;70;494;3;0;33676
2022-02-07 14:30;32463;75;494;2;0;33034
2022-02-07 15:30;32752;65;493;1;0;33311
2022-02-07 16:30;33676;103;491;0;0;34270
2022-02-07 17:30;34597;214;496;0;0;35307
2022-02-07 18:30;34293;396;496;0;0;35185
2022-02-07 19:30;33911;474;496;0;0;34881
2022-02-07 20:30;33998;538;495;0;0;35031
2022-02-07 21:30;33063;618;494;0;0;34175
2022-02-07 22:30;31676;530;494;0;0;32700
2022-02-07 23:30;30892;379;495;0;0;31766
2022-02-08 00:30;29961;312;493;0;0;30766
2022-02-08 01:30;29534;404;494;0;0;30432
2022-02-08 02:30;29364;492;493;0;0;30349
2022-02-08 03:30;29529;592;487;0;0;30608
2022-02-08 04:30;29526;746;493;0;0;30765
2022-02-08 05:30;29910;879;496;0;0;31285
2022-02-08 06:30;31950;927;493;0;0;33370
2022-02-08 07:30;33331;1027;491;0;0;34849
2022-02-08 08:30;32883;1007;492;1;0;34383
2022-02-08 09:30;31862;917;497;2;0;33278
2022-02-08 10:30;30884;793;494;3;0;32174
2022-02-08 11:30;30263;914;495;3;0;31675
2022-02-08 12:30;30024;1021;494;3;0;31542
2022-02-08 13:30;29255;1032;490;2;0;30779
2022-02-08 14:30;28711;1034;490;1;0;30236
2022-02-08 15:30;29263;1065;493;1;0;30822
2022-02-08 16:30;30286;1207;493;0;0;31986
2022-02-08 17:30;32755;1385;495;0;0;34635
2022-02-08 18:30;32918;1419;497;0;0;34834
2022-02-08 19:30;31979;1395;499;0;0;33873
2022-02-08 20:30;31129;1349;497;0;0;32975
2022-02-08 21:30;29697;1370;496;0;0;31563
2022-02-08 22:30;27998;1226;496;0;0;29720
2022-02-08 23:30;27098;1071;492;0;0;28661
2022-02-09 00:30;26306;1014;493;0;0;27813
2022-02-09 01:30;26309;954;493;0;0;27756
2022-02-09 02:30;26340;892;494;0;0;27726
2022-02-09 03:30;26621;812;492;0;0;27925
2022-02-09 04:30;27723;712;492;0;0;28927
2022-02-09 05:30;28995;587;495;0;0;30077
2022-02-09 06:30;31386;465;488;0;0;32339
2022-02-09 07:30;31605;452;488;0;0;32545
2022-02-09 08:30;30909;445;489;3;0;31846
2022-02-09 09:30;29044;422;487;5;0;29958
2022-02-09 10:30;27459;396;489;6;0;28350
2022-02-09 11:30;26843;497;487;8;0;27835
2022-02-09 12:30;25847;511;486;7;0;26851
2022-02-09 13:30;25813;428;486;5;0;26732
2022-02-09 14:30;25596;291;486;7;0;26380
2022-02-09 15:30;26281;345;483;3;0;27112
2022-02-09 16:30;28310;497;484;1;0;29292
2022-02-09 17:30;30151;806;486;0;0;31443
2022-02-09 18:30;29952;1023;487;0;0;31462
2022-02-09 19:30;29182;1206;488;0;0;30876
2022-02-09 20:30;28301;1389;487;0;0;30177
2022-02-09 21:30;27232;1520;491;0;0;29243
2022-02-09 22:30;25381;1624;491;0;0;27496
2022-02-09 23:30;23448;1745;498;0;0;25691
2022-02-10 00:30;22625;1720;496;0;0;24841
2022-02-10 01:30;22240;1638;497;0;0;24375
2022-02-10 02:30;21959;1582;497;0;0;24038
2022-02-10 03:30;22116;1399;497;0;0;24012
2022-02-10 04:30;22765;1304;496;0;0;24565
2022-02-10 05:30;24071;1244;495;0;0;25810
2022-02-10 06:30;26427;1125;498;0;0;28050
2022-02-10 07:30;28157;1250;497;0;0;29904
2022-02-10 08:30;28278;1261;498;1;0;30038
2022-02-10 09:30;27594;1292;496;3;0;29385
2022-02-10 10:30;27521;1389;495;1;0;29406
2022-02-10 11:30;26862;1374;495;2;0;28733
2022-02-10 12:30;25865;1418;497;4;0;27784
2022-02-10 13:30;25880;1586;497;4;0;27967
2022-02-10 14:30;25306;1820;497;2;0;27625
2022-02-10 15:30;24961;2011;495;2;0;27469
2022-02-10 16:30;26897;2112;496;1;0;29506
2022-02-10 17:30;28786;2176;496;0;0;31458
2022-02-10 18:30;29011;2140;496;0;0;31647
2022-02-10 19:30;28894;2222;496;0;0;31612
2022-02-10 20:30;28502;2373;498;0;0;31373
2022-02-10 21:30;26997;2324;496;0;0;29817
2022-02-10 22:30;24930;2308;494;0;0;27732
2022-02-10 23:30;23607;2263;495;0;0;26365
2022-02-11 00:30;23351;2202;495;0;0;26048
2022-02-11 01:30;22849;2192;496;0;0;25537
2022-02-11 02:30;22865;2055;494;0;0;25414
2022-02-11 03:30;23288;1964;493;0;0;25745
2022-02-11 04:30;23598;1885;493;0;0;25976
2022-02-11 05:30;25110;1913;489;0;0;27512
2022-02-11 06:30;27433;1612;491;0;0;29536
2022-02-11 07:30;30012;1199;491;0;0;31702
2022-02-11 08:30;30532;1088;491;0;0;32111
2022-02-11 09:30;29914;957;488;1;0;31360
2022-02-11 10:30;28790;883;488;6;0;30167
2022-02-11 11:30;27961;896;488;5;0;29350
2022-02-11 12:30;27888;949;489;5;0;29331
2022-02-11 13:30;27363;962;488;4;0;28817
2022-02-11 14:30;26782;1029;489;2;0;28302
2022-02-11 15:30;26665;1265;489;1;0;28420
2022-02-11 16:30;27253;1504;486;0;0;29243
2022-02-11 17:30;28244;2027;480;0;0;30751
2022-02-11 18:30;27821;2424;478;0;0;30723
2022-02-11 19:30;26730;2701;478;0;0;29909
2022-02-11 20:30;25354;2865;479;0;0;28698
2022-02-11 21:30;24730;2965;479;0;0;28174
2022-02-11 22:30;23749;2875;478;0;0;27102
2022-02-11 23:30;22042;2985;479;0;0;25506
2022-02-12 00:30;22273;2657;480;0;0;25410
2022-02-12 01:30;22060;2614;478;0;0;25152
2022-02-12 02:30;22200;2518;478;0;0;25196
2022-02-12 03:30;22385;2309;479;0;0;25173
2022-02-12 04:30;22576;2241;482;0;0;25299
2022-02-12 05:30;23010;2199;483;0;0;25692
2022-02-12 06:30;23715;2049;483;0;0;26247
2022-02-12 07:30;25259;2284;478;0;0;28021
2022-02-12 08:30;26396;2161;476;1;0;29034
2022-02-12 09:30;27421;1806;474;3;0;29704
2022-02-12 10:30;27642;1781;476;3;0;29902
2022-02-12 11:30;27672;1772;479;3;0;29926
2022-02-12 12:30;28318;1818;476;3;0;30615
2022-02-12 13:30;28153;1828;479;2;0;30462
2022-02-12 14:30;27934;1859;480;1;0;30274
2022-02-12 15:30;29016;1934;483;1;0;31434
2022-02-12 16:30;30013;1842;486;0;0;32341
2022-02-12 17:30;31972;2512;483;0;0;34967
2022-02-12 18:30;32037;2534;482;0;0;35053
2022-02-12 19:30;31556;2926;482;0;0;34964
2022-02-12 20:30;31417;2537;482;0;0;34436
2022-02-12 21:30;31494;2416;482;0;0;34392
2022-02-12 22:30;31295;2277;482;0;0;34054
2022-02-12 23:30;30986;2128;481;0;0;33595
2022-02-13 00:30;31346;1773;478;0;0;33597
2022-02-13 01:30;31495;1636;479;0;0;33610
2022-02-13 02:30;31895;1448;480;0;0;33823
2022-02-13 03:30;31707;1761;482;0;0;33950
2022-02-13 04:30;33380;1348;479;0;0;35207
2022-02-13 05:30;34299;1175;479;0;0;35953
2022-02-13 06:30;35073;1449;480;0;0;37002
2022-02-13 07:30;35560;1201;479;0;0;37240
2022-02-13 08:30;35493;899;476;4;0;36872
2022-02-13 09:30;34979;667;478;7;0;36131
2022-02-13 10:30;34316;524;477;9;0;35326
2022-02-13 11:30;34528;446;477;9;0;35460
2022-02-13 12:30;34219;357;478;9;0;35063
2022-02-13 13:30;33317;304;479;9;0;34109
2022-02-13 14:30;32775;265;481;8;0;33529
2022-02-13 15:30;33026;225;481;6;0;33738
2022-02-13 16:30;33530;299;483;1;0;34313
2022-02-13 17:30;35178;456;483;0;0;36117
2022-02-13 18:30;35246;579;484;0;0;36309
2022-02-13 19:30;34070;772;485;0;0;35327
2022-02-13 20:30;34662;737;487;0;0;35886
2022-02-13 21:30;34129;825;486;0;0;35440
2022-02-13 22:30;34057;776;485;0;0;35318
2022-02-13 23:30;33188;625;487;0;0;34300
2022-02-14 00:30;33194;593;485;0;0;34272
2022-02-14 01:30;33163;510;485;0;0;34158
2022-02-14 02:30;32876;556;486;0;0;33918
2022-02-14 03:30;32754;563;485;0;0;33802
2022-02-14 04:30;33373;454;484;0;0;34311
2022-02-14 05:30;32712;360;477;0;0;33549
2022-02-14 06:30;33647;418;479;0;0;34544
2022-02-14 07:30;35065;336;476;0;0;35877
2022-02-14 08:30;34699;256;478;1;0;35434
2022-02-14 09:30;34695;227;477;2;0;35401
2022-02-14 10:30;33249;189;479;7;0;33924
2022-02-14 11:30;33074;284;485;6;0;33849
2022-02-14 12:30;32970;335;487;8;0;33800
2022-02-14 13:30;33365;440;485;9;0;34299
2022-02-14 14:30;33428;715;486;8;0;34637
2022-02-14 15:30;32552;834;487;6;0;33879
2022-02-14 16:30;32785;899;484;1;0;34169
2022-02-14 17:30;34811;1057;485;0;0;36353
2022-02-14 18:30;34729;1529;485;0;0;36743
2022-02-14 19:30;34293;1933;486;0;0;36712
2022-02-14 20:30;33901;2000;484;0;0;36385
2022-02-14 21:30;34080;2055;483;0;0;36618
2022-02-14 22:30;33999;2120;484;0;0;36603
2022-02-14 23:30;32363;2172;485;0;0;35020
2022-02-15 00:30;33075;1808;485;0;0;35368
2022-02-15 01:30;33453;2174;484;0;0;36111
2022-02-15 02:30;33029;2169;484;0;0;35682
2022-02-15 03:30;32755;2182;483;0;0;35420
2022-02-15 04:30;34037;2216;484;0;0;36737
2022-02-15 05:30;35329;2062;483;0;0;37874
2022-02-15 06:30;35804;1956;483;0;0;38243
2022-02-15 07:30;36491;1972;482;0;0;38945
2022-02-15 08:30;35981;1917;481;1;0;38380
2022-02-15 09:30;33983;2079;484;3;0;36549
2022-02-15 10:30;32720;2376;478;3;0;35577
2022-02-15 11:30;32835;2358;481;8;0;35682
2022-02-15 12:30;32281;2454;480;9;0;35224
2022-02-15 13:30;31863;2634;480;9;0;34986
2022-02-15 14:30;31535;2476;482;8;0;34501
2022-02-15 15:30;31747;2529;482;6;0;34764
2022-02-15 16:30;32092;2403;482;3;0;34980
2022-02-15 17:30;34815;2329;481;0;0;37625
2022-02-15 18:30;34885;2511;482;0;0;37878
2022-02-15 19:30;34883;2440;484;0;0;37807
2022-02-15 20:30;34522;2443;485;0;0;37450
2022-02-15 21:30;34146;2314;485;0;0;36945
2022-02-15 22:30;33417;2249;484;0;0;36150
2022-02-15 23:30;32764;2025;484;0;0;35273
2022-02-16 00:30;32244;2280;481;0;0;35005
2022-02-16 01:30;32991;2169;530;0;0;35690
2022-02-16 02:30;32516;2095;530;0;0;35141
2022-02-16 03:30;32346;2057;530;0;0;34933
2022-02-16 04:30;32208;1937;530;0;0;34675
2022-02-16 05:30;33219;1781;530;0;0;35530
2022-02-16 06:30;33659;1708;530;0;0;35897
2022-02-16 07:30;34542;1734;530;0;0;36806
2022-02-16 08:30;34676;1644;530;1;0;36851
2022-02-16 09:30;35168;1692;530;2;0;37392
2022-02-16 10:30;34363;1776;530;4;0;36673
2022-02-16 11:30;32900;1956;530;6;0;35392
2022-02-16 12:30;31971;2189;530;4;0;34694
2022-02-16 13:30;30879;2528;530;6;0;33943
2022-02-16 14:30;30106;2446;530;3;0;33085
2022-02-16 15:30;30698;2746;530;0;0;33974
2022-02-16 16:30;31949;2841;530;0;0;35320
2022-02-16 17:30;33275;2742;530;0;0;36547
2022-02-16 18:30;32907;2626;530;0;0;36063
2022-02-16 19:30;30937;2638;530;0;0;34105
2022-02-16 20:30;29823;2509;530;0;0;32862
2022-02-16 21:30;29024;2648;530;0;0;32202
2022-02-16 22:30;26828;2738;530;0;0;30096
2022-02-16 23:30;24939;2702;530;0;0;28171
2022-02-17 00:30;23905;2712;530;0;0;27147
2022-02-17 01:30;23077;2754;530;0;0;26361
2022-02-17 02:30;22181;2753;530;0;0;25464
2022-02-17 03:30;22171;2770;530;0;0;25471
2022-02-17 04:30;22316;2795;530;0;0;25641
2022-02-17 05:30;24036;2798;530;0;0;27364
2022-02-17 06:30;26643;2701;530;0;0;29874
2022-02-17 07:30;28741;3077;530;0;0;32348
2022-02-17 08:30;29727;2650;530;0;0;32907
2022-02-17 09:30;29478;2945;530;0;0;32953
2022-02-17 10:30;29337;2889;530;0;0;32756
2022-02-17 11:30;29152;2445;530;0;0;32127
2022-02-17 12:30;28812;2360;530;0;0;31702
2022-02-17 13:30;29001;2091;530;0;0;31622
2022-02-17 14:30;29104;2125;530;0;0;31759
2022-02-17 15:30;29712;1604;530;0;0;31846
2022-02-17 16:30;30741;1057;530;0;0;32328
2022-02-17 17:30;32399;828;530;0;0;33757
2022-02-17 18:30;32023;733;530;0;0;33286
2022-02-17 19:30;31914;657;530;0;0;33101
2022-02-17 20:30;31699;649;530;0;0;32878
2022-02-17 21:30;30810;616;530;0;0;31956
2022-02-17 22:30;29855;584;530;0;0;30969
2022-02-17 23:30;28265;610;530;0;0;29405
2022-02-18 00:30;28089;772;530;0;0;29391
2022-02-18 01:30;27032;905;530;0;0;28467
2022-02-18 02:30;26699;1051;530;0;0;28280
2022-02-18 03:30;26874;1453;530;0;0;28857
2022-02-18 04:30;28360;1823;530;0;0;30713
2022-02-18 05:30;30144;1985;530;0;0;32659
2022-02-18 06:30;32583;2177;530;0;0;35290
2022-02-18 07:30;33464;1807;530;0;0;35801
2022-02-18 08:30;33853;1805;530;0;0;36188
2022-02-18 09:30;33382;1745;530;0;0;35657
2022-02-18 10:30;33333;1709;530;1;0;35573
2022-02-18 11:30;31707;1451;530;1;0;33689
2022-02-18 12:30;30828;1555;530;1;0;32914
2022-02-18 13:30;30531;1694;530;1;0;32756
2022-02-18 14:30;30487;1598;530;1;0;32616
2022-02-18 15:30;30730;1812;530;0;0;33072
2022-02-18 16:30;32238;2331;530;0;0;35099
2022-02-18 17:30;34402;2296;530;0;0;37228
2022-02-18 18:30;35054;2300;530;0;0;37884
2022-02-18 19:30;34805;2051;530;0;0;37386
2022-02-18 20:30;34211;1934;530;0;0;36675
2022-02-18 21:30;33608;1591;530;0;0;35729
2022-02-18 22:30;32884;1063;530;0;0;34477
2022-02-18 23:30;31492;923;530;0;0;32945
2022-02-19 00:30;31493;876;530;0;0;32899
2022-02-19 01:30;31236;794;530;0;0;32560
2022-02-19 02:30;31387;743;530;0;0;32660
2022-02-19 03:30;31441;593;530;0;0;32564
2022-02-19 04:30;31978;442;530;0;0;32950
2022-02-19 05:30;33301;386;530;0;0;34217
2022-02-19 06:30;34333;466;530;0;0;35329
2022-02-19 07:30;34693;633;530;0;0;35856
2022-02-19 08:30;34967;853;530;0;0;36350
2022-02-19 09:30;34944;921;530;0;0;36395
2022-02-19 10:30;34160;987;530;0;0;35677
2022-02-19 11:30;33499;1053;530;1;0;35083
2022-02-19 12:30;32535;1115;530;1;0;34181
2022-02-19 13:30;31731;1219;530;2;0;33482
2022-02-19 14:30;30639;1035;530;1;0;32205
2022-02-19 15:30;31800;942;530;1;0;33273
2022-02-19 16:30;33332;970;530;0;0;34832
2022-02-19 17:30;34371;920;530;0;0;35821
2022-02-19 18:30;34692;1031;530;0;0;36253
2022-02-19 19:30;34322;896;530;0;0;35748
2022-02-19 20:30;33816;989;530;0;0;35335
2022-02-19 21:30;33995;1038;530;0;0;35563
2022-02-19 22:30;33639;1225;530;0;0;35394
2022-02-19 23:30;31605;1313;530;0;0;33448
2022-02-20 00:30;31173;1596;530;0;0;33299
2022-02-20 01:30;31029;1779;530;0;0;33338
2022-02-20 02:30;30729;2002;530;0;0;33261
2022-02-20 03:30;31243;2059;530;0;0;33832
2022-02-20 04:30;31749;1630;530;0;0;33909
2022-02-20 05:30;33630;1530;530;0;0;35690
2022-02-20 06:30;34363;1949;530;0;0;36842
2022-02-20 07:30;34355;1847;530;0;0;36732
2022-02-20 08:30;33632;1577;530;1;0;35740
2022-02-20 09:30;33383;1099;530;2;0;35014
2022-02-20 10:30;33269;885;530;2;0;34686
2022-02-20 11:30;33599;832;530;1;0;34962
2022-02-20 12:30;34676;779;530;1;0;35986
2022-02-20 13:30;33417;717;530;1;0;34665
2022-02-20 14:30;32723;898;530;1;0;34152
2022-02-20 15:30;32944;1139;530;0;0;34613
2022-02-20 16:30;33193;1557;530;0;0;35280
2022-02-20 17:30;34110;1878;530;0;0;36518
2022-02-20 18:30;33882;2079;530;0;0;36491
2022-02-20 19:30;32811;2406;530;0;0;35747
2022-02-20 20:30;30932;2114;530;0;0;33576
2022-02-20 21:30;29707;2252;530;0;0;32489
2022-02-20 22:30;28124;2295;530;0;0;30949
2022-02-20 23:30;26846;2400;530;0;0;29776
2022-02-21 00:30;26220;2464;530;0;0;29214
2022-02-21 01:30;25785;2414;530;0;0;28729
2022-02-21 02:30;26401;2198;530;0;0;29129
2022-02-21 03:30;25806;2583;530;0;0;28919
2022-02-21 04:30;26712;2464;530;0;0;29706
2022-02-21 05:30;28302;2331;530;0;0;31163
2022-02-21 06:30;30156;2162;530;0;0;32848
2022-02-21 07:30;31756;2105;530;0;0;34391
2022-02-21 08:30;31041;2066;530;2;0;33639
2022-02-21 09:30;30281;2234;530;1;0;33046
2022-02-21 10:30;30425;1807;528;1;0;32761
2022-02-21 11:30;29688;2069;528;1;0;32286
2022-02-21 12:30;30119;2006;530;1;0;32656
2022-02-21 13:30;29879;1832;540;1;0;32252
2022-02-21 14:30;29813;1790;538;1;0;32142
2022-02-21 15:30;31033;1579;535;1;0;33148
2022-02-21 16:30;32894;1331;537;0;0;34762
2022-02-21 17:30;34640;1270;539;0;0;36449
2022-02-21 18:30;34730;1377;538;0;0;36645
2022-02-21 19:30;34356;1374;532;0;0;36262
2022-02-21 20:30;33736;1341;531;0;0;35608
2022-02-21 21:30;32571;1260;532;0;0;34363
2022-02-21 22:30;31021;1213;530;0;0;32764
2022-02-21 23:30;29775;1243;529;0;0;31547
2022-02-22 00:30;29489;1256;530;0;0;31275
2022-02-22 01:30;29260;1283;531;0;0;31074
2022-02-22 02:30;29621;1271;531;0;0;31423
2022-02-22 03:30;29399;1388;530;0;0;31317
2022-02-22 04:30;30018;1311;529;0;0;31858
2022-02-22 05:30;32009;1428;530;0;0;33967
2022-02-22 06:30;33829;1512;530;0;0;35871
2022-02-22 07:30;35384;1679;529;0;0;37592
2022-02-22 08:30;35664;1710;531;1;0;37906
2022-02-22 09:30;35330;1736;527;1;0;37594
2022-02-22 10:30;34603;1810;521;4;0;36938
2022-02-22 11:30;33538;1937;522;5;0;36002
2022-02-22 12:30;33257;1685;527;4;0;35473
2022-02-22 13:30;33242;1698;533;4;0;35477
2022-02-22 14:30;33087;1884;535;2;0;35508
2022-02-22 15:30;33212;1964;536;1;0;35713
2022-02-22 16:30;34166;2034;539;0;0;36739
2022-02-22 17:30;35063;2047;538;0;0;37648
2022-02-22 18:30;34649;1943;539;0;0;37131
2022-02-22 19:30;33505;1934;537;0;0;35976
2022-02-22 20:30;32805;1992;538;0;0;35335
2022-02-22 21:30;31444;1911;539;0;0;33894
2022-02-22 22:30;29508;1918;538;0;0;31964
2022-02-22 23:30;27545;1812;539;0;0;29896
2022-02-23 00:30;26813;1853;534;0;0;29200
2022-02-23 01:30;25750;1986;530;0;0;28266
2022-02-23 02:30;24408;2156;528;0;0;27092
2022-02-23 03:30;24857;2439;529;0;0;27825
2022-02-23 04:30;25867;1851;526;0;0;28244
2022-02-23 05:30;28295;1219;527;0;0;30041
2022-02-23 06:30;31140;1035;525;0;0;32700
2022-02-23 07:30;31665;1146;527;0;0;33338
2022-02-23 08:30;31502;1207;528;1;0;33238
2022-02-23 09:30;31298;1238;527;0;0;33063
2022-02-23 10:30;31789;1274;529;1;0;33593
2022-02-23 11:30;32307;1096;529;1;0;33933
2022-02-23 12:30;31615;1000;526;2;0;33143
2022-02-23 13:30;31003;939;529;7;0;32478
2022-02-23 14:30;30741;946;524;7;0;32218
2022-02-23 15:30;31429;1127;520;6;0;33082
2022-02-23 16:30;32433;1522;520;2;0;34477
2022-02-23 17:30;34007;1782;524;0;0;36313
2022-02-23 18:30;34263;2014;524;0;0;36801
2022-02-23 19:30;33801;2175;526;0;0;36502
2022-02-23 20:30;32925;2362;525;0;0;35812
2022-02-23 21:30;32514;2415;528;0;0;35457
2022-02-23 22:30;31365;2513;530;0;0;34408
2022-02-23 23:30;30496;2545;526;0;0;33567
2022-02-24 00:30;30305;2545;524;0;0;33374
2022-02-24 01:30;30349;2453;524;0;0;33326
2022-02-24 02:30;30247;2419;522;0;0;33188
2022-02-24 03:30;30480;2332;523;0;0;33335
2022-02-24 04:30;31498;2225;522;0;0;34245
2022-02-24 05:30;33724;2141;524;0;0;36389
2022-02-24 06:30;35881;2077;525;0;0;38483
2022-02-24 07:30;36471;1819;524;1;299;39114
2022-02-24 08:30;35916;1770;523;2;42;38253
2022-02-24 09:30;34506;1547;521;8;0;36582
2022-02-24 10:30;32586;1409;520;9;0;34524
2022-02-24 11:30;32624;1368;519;9;0;34520
2022-02-24 12:30;31746;1375;513;9;0;33643
2022-02-24 13:30;31269;1379;515;9;0;33172
2022-02-24 14:30;30731;1494;518;8;0;32751
2022-02-24 15:30;30916;1587;519;6;0;33028
2022-02-24 16:30;31731;1596;525;3;0;33855
2022-02-24 17:30;34443;1674;525;0;0;36642
2022-02-24 18:30;35430;1698;526;0;0;37654
2022-02-24 19:30;34530;1695;526;0;0;36751
2022-02-24 20:30;34729;1442;528;0;0;36699
2022-02-24 21:30;33938;1411;528;0;0;35877
2022-02-24 22:30;33365;1349;529;0;0;35243
2022-02-24 23:30;31534;1292;526;0;0;33352
2022-02-25 00:30;30798;1220;527;0;0;32545
2022-02-25 01:30;30782;1058;527;0;0;32367
2022-02-25 02:30;30911;935;524;0;0;32370
2022-02-25 03:30;30796;903;527;0;0;32226
2022-02-25 04:30;31240;791;529;0;0;32560
2022-02-25 05:30;33626;782;529;0;0;34937
2022-02-25 06:30;34814;776;528;0;0;36118
2022-02-25 07:30;35738;745;527;0;0;37010
2022-02-25 08:30;36112;692;517;0;0;37321
2022-02-25 09:30;36751;581;518;0;202;38052
2022-02-25 10:30;35978;514;519;0;296;37307
2022-02-25 11:30;36223;462;522;0;397;37604
2022-02-25 12:30;35820;412;528;0;397;37157
2022-02-25 13:30;35091;363;520;0;197;36171
2022-02-25 14:30;34757;266;520;0;0;35543
2022-02-25 15:30;35017;248;524;0;0;35789
2022-02-25 16:30;35293;264;528;0;0;36085
2022-02-25 17:30;36360;269;521;0;0;37150
2022-02-25 18:30;36346;564;520;0;0;37430
2022-02-25 19:30;36001;776;522;0;0;37299
2022-02-25 20:30;34920;969;529;0;0;36418
2022-02-25 21:30;34698;1103;530;0;0;36331
2022-02-25 22:30;33436;1066;531;0;0;35033
2022-02-25 23:30;31898;1130;530;0;0;33558
2022-02-26 00:30;32320;1256;532;0;0;34108
2022-02-26 01:30;32368;1310;532;0;0;34210
2022-02-26 02:30;32207;1507;532;0;0;34246
2022-02-26 03:30;32068;1572;531;0;0;34171
2022-02-26 04:30;32309;1765;531;0;0;34605
2022-02-26 05:30;34553;1677;531;0;0;36761
2022-02-26 06:30;35667;1595;530;0;0;37792
2022-02-26 07:30;35623;1776;531;0;0;37930
2022-02-26 08:30;34834;1651;528;1;0;37014
2022-02-26 09:30;34503;1438;526;2;0;36469
2022-02-26 10:30;32456;1353;526;3;0;34338
2022-02-26 11:30;31664;1405;527;5;0;33601
2022-02-26 12:30;29960;1641;529;7;0;32137
2022-02-26 13:30;28533;1928;526;8;0;30995
2022-02-26 14:30;27311;1999;527;8;0;29845
2022-02-26 15:30;27625;2125;527;6;0;30283
2022-02-26 16:30;28873;2217;528;3;0;31621
2022-02-26 17:30;31364;2369;531;0;0;34264
2022-02-26 18:30;32280;2740;530;0;0;35550
2022-02-26 19:30;30523;2785;530;0;0;33838
2022-02-26 20:30;29294;2891;530;0;0;32715
2022-02-26 21:30;28960;2554;529;0;0;32043
2022-02-26 22:30;27864;2888;531;0;0;31283
2022-02-26 23:30;27216;2783;532;0;0;30531
2022-02-27 00:30;26852;2730;528;0;0;30110
2022-02-27 01:30;26751;2736;529;0;0;30016
2022-02-27 02:30;26204;2689;527;0;0;29420
2022-02-27 03:30;26355;2589;530;0;0;29474
2022-02-27 04:30;26431;2525;529;0;0;29485
2022-02-27 05:30;26665;2487;529;0;0;29681
2022-02-27 06:30;27746;2423;529;0;0;30698
2022-02-27 07:30;28904;2235;528;0;0;31667
2022-02-27 08:30;30279;2027;525;0;0;32831
2022-02-27 09:30;30646;1832;523;1;0;33002
2022-02-27 10:30;30709;1628;524;4;0;32865
2022-02-27 11:30;30523;1516;522;5;0;32566
2022-02-27 12:30;29851;1541;523;4;0;31919
2022-02-27 13:30;28764;1738;522;5;0;31029
2022-02-27 14:30;27445;1964;523;1;0;29933
2022-02-27 15:30;27799;2118;520;3;0;30440
2022-02-27 16:30;28998;2436;524;2;0;31960
2022-02-27 17:30;31188;2721;526;0;0;34435
2022-02-27 18:30;32510;2772;523;0;0;35805
2022-02-27 19:30;32115;2708;526;0;0;35349
2022-02-27 20:30;31391;2342;528;0;0;34261
2022-02-27 21:30;31228;2955;525;0;0;34708
2022-02-27 22:30;30261;2587;525;0;0;33373
2022-02-27 23:30;29223;2575;524;0;0;32322
2022-02-28 00:30;28774;2579;523;0;0;31876
2022-02-28 01:30;28620;3059;520;0;0;32199
2022-02-28 02:30;29224;2641;519;0;0;32384
2022-02-28 03:30;28913;2612;520;0;0;32045
2022-02-28 04:30;30796;2576;521;0;0;33893
2022-02-28 05:30;32160;2518;521;0;0;35199
2022-02-28 06:30;33118;2866;520;0;0;36504
2022-02-28 07:30;33818;2429;520;1;0;36768
2022-02-28 08:30;32708;2380;517;5;0;35610
2022-02-28 09:30;33385;2260;516;8;0;36169
2022-02-28 10:30;32958;2616;514;9;0;36097
2022-02-28 11:30;31873;2328;519;9;0;34729
2022-02-28 12:30;30973;2321;520;9;0;33823
2022-02-28 13:30;30004;2360;518;9;0;32891
2022-02-28 14:30;29149;2483;517;9;0;32158
2022-02-28 15:30;29561;2445;517;6;0;32529
2022-02-28 16:30;31188;2460;523;3;0;34174
2022-02-28 17:30;32293;2511;524;0;0;35328
2022-02-28 18:30;33064;3073;525;0;0;36662
2022-02-28 19:30;33583;2720;526;0;0;36829
2022-02-28 20:30;33226;2658;525;0;0;36409
2022-02-28 21:30;32843;2580;525;0;0;35948
2022-02-28 22:30;32927;2794;524;0;0;36245
2022-02-28 23:30;30852;2503;525;0;0;33880
2022-03-01 00:30;30682;2270;518;0;0;33470
2022-03-01 01:30;30838;2041;524;0;0;33403
2022-03-01 02:30;30717;1634;528;0;0;32879
2022-03-01 03:30;31334;1581;529;0;0;33444
2022-03-01 04:30;31619;1381;529;0;0;33529
2022-03-01 05:30;32815;1323;529;0;0;34667
2022-03-01 06:30;34644;1162;529;0;0;36335
2022-03-01 07:30;35324;995;528;1;0;36848
2022-03-01 08:30;34558;751;527;2;0;35838
2022-03-01 09:30;34639;504;522;2;0;35667
2022-03-01 10:30;33827;296;521;3;0;34647
2022-03-01 11:30;33690;288;523;1;0;34502
2022-03-01 12:30;33391;317;523;1;0;34232
2022-03-01 13:30;34101;373;523;0;0;34997
2022-03-01 14:30;34501;472;522;0;0;35495
2022-03-01 15:30;34518;529;521;0;0;35568
2022-03-01 16:30;33884;801;522;0;0;35207
2022-03-01 17:30;34326;1130;521;0;0;35977
2022-03-01 18:30;34605;1322;525;0;0;36452
2022-03-01 19:30;34309;1288;527;0;0;36124
2022-03-01 20:30;32739;1590;527;0;0;34856
2022-03-01 21:30;32210;1457;527;0;0;34194
2022-03-01 22:30;31095;1242;527;0;0;32864
2022-03-01 23:30;29757;1226;528;0;0;31511
2022-03-02 00:30;30433;1113;532;0;0;32078
2022-03-02 01:30;30411;1032;531;0;0;31974
2022-03-02 02:30;30306;1124;530;0;0;31960
2022-03-02 03:30;30559;1048;529;0;0;32136
2022-03-02 04:30;32044;923;531;0;0;33498
2022-03-02 05:30;32462;859;530;0;0;33851
2022-03-02 06:30;34863;772;531;0;0;36166
2022-03-02 07:30;34895;653;535;0;0;36083
2022-03-02 08:30;34542;587;534;0;0;35663
2022-03-02 09:30;32318;728;530;1;0;33577
2022-03-02 10:30;31153;1085;529;2;0;32769
2022-03-02 11:30;30237;1338;527;3;0;32105
2022-03-02 12:30;29297;1476;527;6;0;31306
2022-03-02 13:30;28167;1728;504;7;0;30406
2022-03-02 14:30;26924;1863;503;6;0;29296
2022-03-02 15:30;28892;1796;501;5;0;31194
2022-03-02 16:30;30812;1895;501;1;0;33209
2022-03-02 17:30;32316;1868;506;0;0;34690
2022-03-02 18:30;32809;1913;512;0;0;35234
2022-03-02 19:30;32125;2000;513;0;0;34638
2022-03-02 20:30;31313;1895;512;0;0;33720
2022-03-02 21:30;31601;1616;512;0;0;33729
2022-03-02 22:30;30965;1505;514;0;0;32984
2022-03-02 23:30;29407;1416;514;0;0;31337
2022-03-03 00:30;28831;1155;512;0;0;30498
2022-03-03 01:30;28660;1055;511;0;0;30226
2022-03-03 02:30;28736;918;511;0;0;30165
2022-03-03 03:30;28935;914;510;0;0;30359
2022-03-03 04:30;30141;1002;512;0;0;31655
2022-03-03 05:30;31983;1206;512;0;0;33701
2022-03-03 06:30;33709;1228;513;0;0;35450
2022-03-03 07:30;34454;1214;512;0;0;36180
2022-03-03 08:30;32871;1278;508;1;0;34658
2022-03-03 09:30;31461;1353;509;2;0;33325
2022-03-03 10:30;31318;1401;512;2;0;33233
2022-03-03 11:30;30843;1707;508;5;0;33063
2022-03-03 12:30;30089;1998;524;9;0;32620
2022-03-03 13:30;29275;2465;524;7;0;32271
2022-03-03 14:30;28787;2493;524;7;0;31811
2022-03-03 15:30;29534;2430;522;6;0;32492
2022-03-03 16:30;31017;2530;524;3;0;34074
2022-03-03 17:30;32280;2800;527;0;0;35607
2022-03-03 18:30;33153;2939;527;0;0;36619
2022-03-03 19:30;33284;3080;528;0;0;36892
2022-03-03 20:30;33257;2734;527;0;0;36518
2022-03-03 21:30;33399;2740;527;0;0;36666
2022-03-03 22:30;32047;2705;528;0;0;35280
2022-03-03 23:30;31456;2656;527;0;0;34639
2022-03-04 00:30;31675;2515;528;0;0;34718
2022-03-04 01:30;31867;2842;528;0;0;35237
2022-03-04 02:30;31692;2364;524;0;0;34580
2022-03-04 03:30;31731;2383;520;0;0;34634
2022-03-04 04:30;32918;2739;522;0;0;36179
2022-03-04 05:30;33020;2669;523;0;0;36212
2022-03-04 06:30;34102;2670;522;0;0;37294
2022-03-04 07:30;34179;2734;523;0;0;37436
2022-03-04 08:30;33208;2489;523;5;0;36225
2022-03-04 09:30;32687;2608;526;7;0;35828
2022-03-04 10:30;31335;2775;521;9;0;34640
2022-03-04 11:30;31199;2857;521;9;0;34586
2022-03-04 12:30;30042;2882;522;8;0;33454
2022-03-04 13:30;28493;2699;524;9;0;31725
2022-03-04 14:30;27825;2211;521;7;0;30564
2022-03-04 15:30;27972;2351;522;6;0;30851
2022-03-04 16:30;29411;2766;518;3;0;32698
2022-03-04 17:30;31439;2694;521;0;0;34654
2022-03-04 18:30;32430;2844;522;0;0;35796
2022-03-04 19:30;31726;2952;526;0;0;35204
2022-03-04 20:30;31451;2920;526;0;0;34897
2022-03-04 21:30;30372;2658;534;0;0;33564
2022-03-04 22:30;29563;2952;531;0;0;33046
2022-03-04 23:30;28655;2613;530;0;0;31798
2022-03-05 00:30;28720;2460;530;0;0;31710
2022-03-05 01:30;29034;2347;532;0;0;31913
2022-03-05 02:30;29708;2241;532;0;0;32481
2022-03-05 03:30;29996;2301;532;0;0;32829
2022-03-05 04:30;30503;2308;533;0;0;33344
2022-03-05 05:30;31675;2281;533;0;0;34489
2022-03-05 06:30;32612;2346;530;0;0;35488
2022-03-05 07:30;32529;2203;529;2;0;35263
2022-03-05 08:30;31197;2194;532;5;0;33928
2022-03-05 09:30;30486;2403;531;8;0;33428
2022-03-05 10:30;29418;2313;531;9;0;32271
2022-03-05 11:30;28630;2295;532;9;0;31466
2022-03-05 12:30;27870;2272;513;9;0;30664
2022-03-05 13:30;26905;2332;513;8;0;29758
2022-03-05 14:30;26075;1956;515;7;0;28553
2022-03-05 15:30;26648;1789;514;5;0;28956
2022-03-05 16:30;28560;2166;515;1;0;31242
2022-03-05 17:30;30112;2288;514;0;0;32914
2022-03-05 18:30;30526;1916;514;0;0;32956
2022-03-05 19:30;30121;1849;516;0;0;32486
2022-03-05 20:30;29625;1745;514;0;0;31884
2022-03-05 21:30;29538;1907;513;0;0;31958
2022-03-05 22:30;28350;1561;510;0;0;30421
2022-03-05 23:30;27431;1338;512;0;0;29281
2022-03-06 00:30;26641;1188;514;0;0;28343
2022-03-06 01:30;26058;989;514;0;0;27561
2022-03-06 02:30;26310;799;512;0;0;27621
2022-03-06 03:30;25946;814;513;0;0;27273
2022-03-06 04:30;25924;929;510;0;0;27363
2022-03-06 05:30;25952;1226;512;0;0;27690
2022-03-06 06:30;26511;1396;512;0;0;28419
2022-03-06 07:30;27594;1540;511;0;0;29645
2022-03-06 08:30;27718;1799;511;0;0;30028
2022-03-06 09:30;27985;1902;512;0;0;30399
2022-03-06 10:30;28334;1966;511;0;0;30811
2022-03-06 11:30;28064;2073;511;1;0;30649
2022-03-06 12:30;26981;2027;492;3;0;29503
2022-03-06 13:30;25644;1752;494;9;0;27899
2022-03-06 14:30;25290;1717;493;1;0;27501
2022-03-06 15:30;24439;1909;494;6;0;26848
2022-03-06 16:30;25535;1973;494;0;0;28002
2022-03-06 17:30;26563;2267;494;0;0;29324
2022-03-06 18:30;27568;2683;493;0;0;30744
2022-03-06 19:30;27906;2305;493;0;0;30704
2022-03-06 20:30;27483;2080;493;0;0;30056
2022-03-06 21:30;26216;1968;493;0;0;28677
2022-03-06 22:30;26005;1671;493;0;0;28169
2022-03-06 23:30;25077;1577;494;0;0;27148
2022-03-07 00:30;24840;1474;495;0;0;26809
2022-03-07 01:30;25086;1291;496;0;0;26873
2022-03-07 02:30;24798;1211;495;0;0;26504
2022-03-07 03:30;24432;1116;492;0;0;26040
2022-03-07 04:30;25693;1177;492;0;0;27362
2022-03-07 05:30;27276;987;490;0;0;28753
2022-03-07 06:30;29856;797;491;0;0;31144
2022-03-07 07:30;31440;689;491;0;0;32620
2022-03-07 08:30;31823;470;483;0;0;32776
2022-03-07 09:30;31500;289;484;1;0;32274
2022-03-07 10:30;31219;162;486;1;0;31868
2022-03-07 11:30;31253;75;485;1;0;31814
2022-03-07 12:30;31274;49;486;1;0;31810
2022-03-07 13:30;31558;48;487;2;0;32095
2022-03-07 14:30;31645;46;486;1;0;32178
2022-03-07 15:30;31660;89;487;1;0;32237
2022-03-07 16:30;31584;127;489;0;0;32200
2022-03-07 17:30;32382;147;489;0;0;33018
2022-03-07 18:30;32687;107;484;0;0;33278
2022-03-07 19:30;32245;112;483;0;0;32840
2022-03-07 20:30;32250;163;482;0;0;32895
2022-03-07 21:30;31481;279;483;0;0;32243
2022-03-07 22:30;30159;430;486;0;0;31075
2022-03-07 23:30;28233;624;487;0;0;29344
2022-03-08 00:30;26543;879;486;0;0;27908
2022-03-08 01:30;25974;1102;488;0;0;27564
2022-03-08 02:30;25659;1231;490;0;0;27380
2022-03-08 03:30;26003;1436;491;0;0;27930
2022-03-08 04:30;26785;1754;492;0;0;29031
2022-03-08 05:30;28403;2143;492;0;0;31038
2022-03-08 06:30;30931;2394;494;0;0;33819
2022-03-08 07:30;31368;2165;493;0;0;34026
2022-03-08 08:30;30041;2482;491;0;0;33014
2022-03-08 09:30;28366;2622;489;1;0;31478
2022-03-08 10:30;27613;2644;490;2;0;30749
2022-03-08 11:30;26923;2708;493;4;0;30128
2022-03-08 12:30;26332;2718;487;8;0;29545
2022-03-08 13:30;26056;2658;485;9;0;29208
2022-03-08 14:30;25289;2607;484;9;0;28389
2022-03-08 15:30;25855;2640;486;6;0;28987
2022-03-08 16:30;27315;2524;484;4;0;30327
2022-03-08 17:30;29701;2435;486;0;0;32622
2022-03-08 18:30;31786;2351;486;0;0;34623
2022-03-08 19:30;31616;2318;485;0;0;34419
2022-03-08 20:30;30405;2303;488;0;0;33196
2022-03-08 21:30;29468;2253;489;0;0;32210
2022-03-08 22:30;29061;2114;487;0;0;31662
2022-03-08 23:30;28206;1915;484;0;0;30605
2022-03-09 00:30;27464;1937;484;0;0;29885
2022-03-09 01:30;26849;2060;486;0;0;29395
2022-03-09 02:30;26865;1920;486;0;0;29271
2022-03-09 03:30;27732;1548;486;0;0;29766
2022-03-09 04:30;28825;1364;487;0;0;30676
2022-03-09 05:30;30766;1163;485;0;0;32414
2022-03-09 06:30;32022;1084;485;0;0;33591
2022-03-09 07:30;32862;945;484;2;0;34293
2022-03-09 08:30;32303;772;480;4;0;33559
2022-03-09 09:30;31192;628;481;5;0;32306
2022-03-09 10:30;30051;603;479;7;0;31140
2022-03-09 11:30;29414;715;483;9;0;30621
2022-03-09 12:30;28449;863;471;8;0;29791
2022-03-09 13:30;28170;924;473;8;0;29575
2022-03-09 14:30;27438;895;471;7;0;28811
2022-03-09 15:30;27885;930;472;3;0;29290
2022-03-09 16:30;29620;946;471;2;0;31039
2022-03-09 17:30;31706;788;478;0;0;32972
2022-03-09 18:30;32272;888;475;0;0;33635
2022-03-09 19:30;31545;1164;477;0;0;33186
2022-03-09 20:30;30647;1384;476;0;0;32507
2022-03-09 21:30;29775;1408;477;0;0;31660
2022-03-09 22:30;28514;1589;479;0;0;30582
2022-03-09 23:30;26377;1746;480;0;0;28603
2022-03-10 00:30;24642;2027;479;0;0;27148
2022-03-10 01:30;24325;2147;477;0;0;26949
2022-03-10 02:30;24075;2156;475;0;0;26706
2022-03-10 03:30;24394;2131;475;0;0;27000
2022-03-10 04:30;25331;2054;478;0;0;27863
2022-03-10 05:30;27163;2157;478;0;0;29798
2022-03-10 06:30;29889;2317;477;0;0;32683
2022-03-10 07:30;30542;2300;478;2;0;33322
2022-03-10 08:30;29405;2289;478;5;0;32177
2022-03-10 09:30;28155;2163;479;7;0;30804
2022-03-10 10:30;27138;2602;469;8;0;30217
2022-03-10 11:30;26695;2739;469;9;0;29912
2022-03-10 12:30;25634;2397;484;9;0;28524
2022-03-10 13:30;25100;2748;485;9;0;28342
2022-03-10 14:30;24121;2854;484;8;0;27467
2022-03-10 15:30;24570;2736;486;7;0;27799
2022-03-10 16:30;26494;2268;488;4;0;29254
2022-03-10 17:30;29267;1758;487;0;0;31512
2022-03-10 18:30;30891;1650;487;0;0;33028
2022-03-10 19:30;30988;1565;485;0;0;33038
2022-03-10 20:30;30903;1483;483;0;0;32869
2022-03-10 21:30;30210;1407;488;0;0;32105
2022-03-10 22:30;28926;1479;487;0;0;30892
2022-03-10 23:30;27813;1440;486;0;0;29739
2022-03-11 00:30;27237;1407;487;0;0;29131
2022-03-11 01:30;26847;1223;485;0;0;28555
2022-03-11 02:30;26625;1146;483;0;0;28254
2022-03-11 03:30;26432;917;483;0;0;27832
2022-03-11 04:30;27952;724;485;0;0;29161
2022-03-11 05:30;30390;501;487;0;0;31378
2022-03-11 06:30;32564;456;486;0;0;33506
2022-03-11 07:30;33523;370;487;1;0;34381
2022-03-11 08:30;33428;390;483;2;0;34303
2022-03-11 09:30;32222;380;475;4;0;33081
2022-03-11 10:30;31295;296;475;5;0;32071
2022-03-11 11:30;30428;232;476;7;0;31143
2022-03-11 12:30;30010;150;484;4;0;30648
2022-03-11 13:30;30030;107;482;4;0;30623
2022-03-11 14:30;29985;106;486;3;0;30580
2022-03-11 15:30;30390;65;483;2;0;30940
2022-03-11 16:30;31743;71;484;1;0;32299
2022-03-11 17:30;33042;164;482;0;0;33688
2022-03-11 18:30;33263;280;484;0;0;34027
2022-03-11 19:30;31991;522;487;0;0;33000
2022-03-11 20:30;31331;725;489;0;0;32545
2022-03-11 21:30;30135;1011;486;0;0;31632
2022-03-11 22:30;28991;1373;486;0;0;30850
2022-03-11 23:30;26538;1717;483;0;0;28738
2022-03-12 00:30;25905;2189;485;0;0;28579
2022-03-12 01:30;25650;2219;487;0;0;28356
2022-03-12 02:30;24730;2069;487;0;0;27286
2022-03-12 03:30;24814;2125;485;0;0;27424
2022-03-12 04:30;24568;2189;486;0;0;27243
2022-03-12 05:30;25727;2071;485;0;0;28283
2022-03-12 06:30;27175;1957;487;0;0;29619
2022-03-12 07:30;28455;1959;487;0;0;30901
2022-03-12 08:30;29206;1734;485;0;0;31425
2022-03-12 09:30;29135;1611;482;0;0;31228
2022-03-12 10:30;29888;1332;482;0;0;31702
2022-03-12 11:30;30190;1149;484;0;0;31823
2022-03-12 12:30;30180;942;483;1;0;31606
2022-03-12 13:30;30009;758;488;1;0;31256
2022-03-12 14:30;29544;706;489;1;0;30740
2022-03-12 15:30;28613;814;491;1;0;29919
2022-03-12 16:30;29511;1332;491;0;0;31334
2022-03-12 17:30;30606;1807;490;0;0;32903
2022-03-12 18:30;30644;1979;495;0;0;33118
2022-03-12 19:30;29904;2146;500;0;0;32550
2022-03-12 20:30;28934;2547;499;0;0;31980
2022-03-12 21:30;28488;2518;500;0;0;31506
2022-03-12 22:30;27753;2609;500;0;0;30862
2022-03-12 23:30;27055;2585;499;0;0;30139
2022-03-13 00:30;26386;2710;499;0;0;29595
2022-03-13 01:30;26063;2801;500;0;0;29364
2022-03-13 03:30;26874;2825;498;0;0;30197
2022-03-13 04:30;27090;2821;498;0;0;30409
2022-03-13 05:30;27903;2810;499;0;0;31212
2022-03-13 06:30;28659;2809;497;0;0;31965
2022-03-13 07:30;30013;2774;498;0;0;33285
2022-03-13 08:30;29738;2795;497;1;0;33031
2022-03-13 09:30;29234;2848;498;3;0;32583
2022-03-13 10:30;28929;2781;499;4;0;32213
2022-03-13 11:30;28375;2782;500;5;0;31662
2022-03-13 12:30;27868;2734;497;7;0;31106
2022-03-13 13:30;26800;3161;496;7;0;30464
2022-03-13 14:30;26204;2751;495;6;0;29456
2022-03-13 15:30;26612;2759;496;6;0;29873
2022-03-13 16:30;27146;2751;496;3;0;30396
2022-03-13 17:30;28621;2693;497;4;0;31815
2022-03-13 18:30;29952;2628;497;0;0;33077
2022-03-13 19:30;30589;2781;500;0;0;33870
2022-03-13 20:30;30624;2612;499;0;0;33735
2022-03-13 21:30;29520;2893;498;0;0;32911
2022-03-13 22:30;28975;2621;498;0;0;32094
2022-03-13 23:30;28003;2462;496;0;0;30961
2022-03-14 00:30;27590;2065;497;0;0;30152
2022-03-14 01:30;27217;1798;496;0;0;29511
2022-03-14 02:30;27829;1474;494;0;0;29797
2022-03-14 03:30;28203;1436;490;0;0;30129
2022-03-14 04:30;28507;1208;494;0;0;30209
2022-03-14 05:30;29936;1278;487;0;0;31701
2022-03-14 06:30;32136;1192;488;0;0;33816
2022-03-14 07:30;33667;1341;489;0;0;35497
2022-03-14 08:30;33211;1350;489;0;0;35050
2022-03-14 09:30;31061;1223;489;1;0;32774
2022-03-14 10:30;30384;1469;487;5;0;32345
2022-03-14 11:30;29092;1855;486;7;0;31440
2022-03-14 12:30;28121;2112;486;9;0;30728
2022-03-14 13:30;26882;2339;500;9;0;29730
2022-03-14 14:30;25736;2514;501;9;0;28760
2022-03-14 15:30;25310;2561;501;8;0;28380
2022-03-14 16:30;26645;2635;502;6;0;29788
2022-03-14 17:30;28182;2486;499;1;0;31168
2022-03-14 18:30;28914;2598;500;0;0;32012
2022-03-14 19:30;29310;2671;500;0;0;32481
2022-03-14 20:30;28900;2659;501;0;0;32060
2022-03-14 21:30;27910;2767;501;0;0;31178
2022-03-14 22:30;26355;2698;504;0;0;29557
2022-03-14 23:30;25061;2434;506;0;0;28001
2022-03-15 00:30;24448;2510;505;0;0;27463
2022-03-15 01:30;24184;2406;508;0;0;27098
2022-03-15 02:30;23830;2332;510;0;0;26672
2022-03-15 03:30;23440;2208;509;0;0;26157
2022-03-15 04:30;23959;2131;506;0;0;26596
2022-03-15 05:30;26231;2064;506;0;0;28801
2022-03-15 06:30;29678;2024;505;0;0;32207
2022-03-15 07:30;31555;1963;504;0;0;34022
2022-03-15 08:30;30865;2004;507;2;0;33378
2022-03-15 09:30;29110;2017;509;5;0;31641
2022-03-15 10:30;27907;1973;498;7;0;30385
2022-03-15 11:30;27495;1854;501;9;0;29859
2022-03-15 12:30;26773;1880;501;9;0;29163
2022-03-15 13:30;26714;1793;512;9;0;29028
2022-03-15 14:30;26022;1710;512;8;0;28252
2022-03-15 15:30;26533;1537;512;6;0;28588
2022-03-15 16:30;27824;1423;512;4;0;29763
2022-03-15 17:30;29457;1154;514;2;0;31127
2022-03-15 18:30;29995;846;514;0;0;31355
2022-03-15 19:30;30622;831;515;0;0;31968
2022-03-15 20:30;30534;847;514;0;0;31895
2022-03-15 21:30;29537;737;515;0;0;30789
2022-03-15 22:30;28861;621;516;0;0;29998
2022-03-15 23:30;27822;524;516;0;0;28862
2022-03-16 00:30;27017;581;516;0;0;28114
2022-03-16 01:30;27019;604;516;0;0;28139
2022-03-16 02:30;26098;808;516;0;0;27422
2022-03-16 03:30;25711;1096;517;0;0;27324
2022-03-16 04:30;26517;1276;516;0;0;28309
2022-03-16 05:30;28100;1720;513;0;0;30333
2022-03-16 06:30;29955;2035;511;0;0;32501
2022-03-16 07:30;31369;2484;513;0;0;34366
2022-03-16 08:30;30626;2488;513;1;0;33628
2022-03-16 09:30;28800;2534;515;5;0;31854
2022-03-16 10:30;27624;2338;517;7;0;30486
2022-03-16 11:30;26469;2087;516;9;0;29081
2022-03-16 12:30;25881;1912;514;9;0;28316
2022-03-16 13:30;25200;1809;491;9;0;27509
2022-03-16 14:30;24527;1813;492;9;0;26841
2022-03-16 15:30;24542;1795;488;4;24;26853
2022-03-16 16:30;25355;1744;491;3;0;27593
2022-03-16 17:30;27362;1519;491;2;0;29374
2022-03-16 18:30;28316;1376;490;0;0;30182
2022-03-16 19:30;28774;1557;489;0;0;30820
2022-03-16 20:30;28403;1662;490;0;0;30555
2022-03-16 21:30;27273;1603;491;0;0;29367
2022-03-16 22:30;25769;1519;492;0;0;27780
2022-03-16 23:30;23687;1198;500;0;0;25385
2022-03-17 00:30;22948;1129;502;0;0;24579
2022-03-17 01:30;22653;983;500;0;0;24136
2022-03-17 02:30;22125;986;501;0;0;23612
2022-03-17 03:30;22280;1181;500;0;0;23961
2022-03-17 04:30;22924;1308;499;0;0;24731
2022-03-17 05:30;24712;1617;498;0;0;26827
2022-03-17 06:30;26868;1771;499;0;0;29138
2022-03-17 07:30;28492;1929;499;0;0;30920
2022-03-17 08:30;27649;2154;499;1;0;30303
2022-03-17 09:30;26347;2135;498;1;0;28981
2022-03-17 10:30;24743;2109;493;8;0;27353
2022-03-17 11:30;24427;2006;497;9;0;26939
2022-03-17 12:30;23869;1965;498;9;0;26341
2022-03-17 13:30;22882;2096;498;9;0;25485
2022-03-17 14:30;22469;2048;499;9;0;25025
2022-03-17 15:30;22384;1779;496;8;0;24667
2022-03-17 16:30;23299;1689;499;6;0;25493
2022-03-17 17:30;23873;1652;497;3;0;26025
2022-03-17 18:30;24260;1812;500;0;0;26572
2022-03-17 19:30;24940;1763;503;0;0;27206
2022-03-17 20:30;25201;1650;503;0;0;27354
2022-03-17 21:30;24786;1827;502;0;0;27115
2022-03-17 22:30;23094;1628;503;0;0;25225
2022-03-17 23:30;21392;1543;502;0;0;23437
2022-03-18 00:30;20776;1433;501;0;0;22710
2022-03-18 01:30;20369;1408;499;0;0;22276
2022-03-18 02:30;20178;1344;515;0;0;22037
2022-03-18 03:30;20124;1490;514;0;0;22128
2022-03-18 04:30;20081;1520;513;0;0;22114
2022-03-18 05:30;22643;1359;511;0;0;24513
2022-03-18 06:30;25223;1326;512;0;0;27061
2022-03-18 07:30;27588;1175;512;0;0;29275
2022-03-18 08:30;28069;921;520;1;0;29511
2022-03-18 09:30;26995;810;522;4;0;28331
2022-03-18 10:30;26634;744;520;7;0;27905
2022-03-18 11:30;26548;698;519;4;0;27769
2022-03-18 12:30;25968;683;521;5;0;27177
2022-03-18 13:30;25379;994;524;2;0;26899
2022-03-18 14:30;24956;1134;525;3;0;26618
2022-03-18 15:30;24698;1209;524;4;0;26435
2022-03-18 16:30;24741;1267;528;3;0;26539
2022-03-18 17:30;25770;1146;524;3;0;27443
2022-03-18 18:30;26087;1104;524;1;0;27716
2022-03-18 19:30;26383;1291;523;0;0;28197
2022-03-18 20:30;25807;1473;522;0;0;27802
2022-03-18 21:30;24768;1605;527;0;0;26900
2022-03-18 22:30;23054;1622;529;0;0;25205
2022-03-18 23:30;21345;1373;527;0;0;23245
2022-03-19 00:30;21078;1249;526;0;0;22853
2022-03-19 01:30;20328;1298;523;0;0;22149
2022-03-19 02:30;19898;1365;522;0;0;21785
2022-03-19 03:30;20197;1418;524;0;0;22139
2022-03-19 04:30;20158;1365;522;0;0;22045
2022-03-19 05:30;21091;1334;520;0;0;22945
2022-03-19 06:30;22427;1349;520;0;0;24296
2022-03-19 07:30;24154;1416;519;0;0;26089
2022-03-19 08:30;26019;1360;521;0;0;27900
2022-03-19 09:30;27184;1373;523;0;0;29080
2022-03-19 10:30;27640;1335;524;0;0;29499
2022-03-19 11:30;27977;1301;524;0;0;29802
2022-03-19 12:30;27744;1427;513;0;0;29684
2022-03-19 13:30;27445;1550;513;1;0;29509
2022-03-19 14:30;27206;1599;512;1;0;29318
2022-03-19 15:30;26820;1794;510;4;0;29128
2022-03-19 16:30;26788;2048;507;2;0;29345
2022-03-19 17:30;27252;2294;509;1;0;30056
2022-03-19 18:30;27052;2319;511;0;0;29882
2022-03-19 19:30;27375;2176;515;0;0;30066
2022-03-19 20:30;26807;2221;516;0;0;29544
2022-03-19 21:30;25785;2019;513;0;0;28317
2022-03-19 22:30;24947;1981;516;0;0;27444
2022-03-19 23:30;23422;1732;514;0;0;25668
2022-03-20 00:30;21948;1705;516;0;0;24169
2022-03-20 01:30;21424;1625;514;0;0;23563
2022-03-20 02:30;21524;1552;510;0;0;23586
2022-03-20 03:30;21208;1511;509;0;0;23228
2022-03-20 04:30;21013;1503;511;0;0;23027
2022-03-20 05:30;22500;1398;511;0;0;24409
2022-03-20 06:30;23257;1260;510;0;0;25027
2022-03-20 07:30;24328;1151;508;0;0;25987
2022-03-20 08:30;25221;1102;507;1;0;26831
2022-03-20 09:30;26361;933;506;1;0;27801
2022-03-20 10:30;27270;730;510;3;0;28513
2022-03-20 11:30;27535;702;510;1;0;28748
2022-03-20 12:30;26972;634;508;1;0;28115
2022-03-20 13:30;26015;611;509;1;0;27136
2022-03-20 14:30;25619;613;510;1;0;26743
2022-03-20 15:30;25547;526;510;1;0;26584
2022-03-20 16:30;26195;489;510;1;0;27195
2022-03-20 17:30;27145;427;510;1;0;28083
2022-03-20 18:30;28374;479;510;0;0;29363
2022-03-20 19:30;29120;557;510;0;0;30187
2022-03-20 20:30;28410;668;506;0;0;29584
2022-03-20 21:30;27595;842;503;0;0;28940
2022-03-20 22:30;26156;910;505;0;0;27571
2022-03-20 23:30;25674;935;504;0;0;27113
2022-03-21 00:30;24254;952;502;0;0;25708
2022-03-21 01:30;24062;839;504;0;0;25405
2022-03-21 02:30;23821;799;504;0;0;25124
2022-03-21 03:30;23908;871;502;0;0;25281
2022-03-21 04:30;24230;958;502;0;0;25690
2022-03-21 05:30;26169;1008;501;0;0;27678
2022-03-21 06:30;28871;1145;504;0;0;30520
2022-03-21 07:30;30932;1272;503;0;0;32707
2022-03-21 08:30;29907;1289;505;3;0;31704
2022-03-21 09:30;28589;1445;505;6;0;30545
2022-03-21 10:30;26926;1577;506;8;0;29017
2022-03-21 11:30;25430;1667;508;9;0;27614
2022-03-21 12:30;24618;1839;500;9;0;26966
2022-03-21 13:30;24277;2085;499;6;0;26867
2022-03-21 14:30;24285;2284;498;3;0;27070
2022-03-21 15:30;24447;2505;504;3;0;27459
2022-03-21 16:30;24845;2693;507;5;0;28050
2022-03-21 17:30;26651;2751;503;3;0;29908
2022-03-21 18:30;27072;2844;505;0;0;30421
2022-03-21 19:30;27676;2980;506;0;0;31162
2022-03-21 20:30;27138;3009;505;0;0;30652
2022-03-21 21:30;26230;3129;505;0;0;29864
2022-03-21 22:30;25168;3152;503;0;0;28823
2022-03-21 23:30;23760;3118;503;0;0;27381
2022-03-22 00:30;22362;3061;502;0;0;25925
2022-03-22 01:30;22401;3068;501;0;0;25970
2022-03-22 02:30;22608;3093;502;0;0;26203
2022-03-22 03:30;23111;3152;502;0;0;26765
2022-03-22 04:30;23778;3118;499;0;0;27395
2022-03-22 05:30;25490;3087;501;0;0;29078
2022-03-22 06:30;28515;3058;501;0;0;32074
2022-03-22 07:30;30068;3056;502;0;0;33626
2022-03-22 08:30;29295;3103;501;2;0;32901
2022-03-22 09:30;27480;2960;500;6;0;30946
2022-03-22 10:30;25848;2993;499;8;0;29348
2022-03-22 11:30;24689;2916;499;9;0;28113
2022-03-22 12:30;23913;2857;505;9;0;27284
2022-03-22 13:30;23085;2701;509;8;0;26303
2022-03-22 14:30;22515;2598;507;6;0;25626
2022-03-22 15:30;23183;2683;505;8;0;26379
2022-03-22 16:30;24206;2796;504;6;0;27512
2022-03-22 17:30;25452;2451;508;3;0;28414
2022-03-22 18:30;25760;2408;509;1;0;28678
2022-03-22 19:30;27082;2483;508;0;0;30073
2022-03-22 20:30;25932;2351;508;0;0;28791
2022-03-22 21:30;25479;2110;508;0;0;28097
2022-03-22 22:30;24524;2138;507;0;0;27169
2022-03-22 23:30;23620;2168;507;0;0;26295
2022-03-23 00:30;23325;1878;508;0;0;25711
2022-03-23 01:30;22793;1778;508;0;0;25079
2022-03-23 02:30;22714;1672;509;0;0;24895
2022-03-23 03:30;23106;1627;508;0;0;25241
2022-03-23 04:30;23644;1609;508;0;0;25761
2022-03-23 05:30;25705;1540;507;0;0;27752
2022-03-23 06:30;27998;1511;506;0;0;30015
2022-03-23 07:30;29097;1494;507;0;0;31098
2022-03-23 08:30;27845;1341;510;3;0;29699
2022-03-23 09:30;27873;1565;509;6;0;29953
2022-03-23 10:30;27765;1444;508;8;0;29725
2022-03-23 11:30;26938;1187;508;9;0;28642
2022-03-23 12:30;27055;1123;519;8;0;28705
2022-03-23 13:30;26915;1131;520;5;0;28571
2022-03-23 14:30;25798;1101;520;4;0;27423
2022-03-23 15:30;26364;991;519;4;0;27878
2022-03-23 16:30;25896;974;519;6;0;27395
2022-03-23 17:30;26945;757;518;5;0;28225
2022-03-23 18:30;27650;611;519;1;0;28781
2022-03-23 19:30;28426;869;520;0;0;29815
2022-03-23 20:30;28433;963;520;0;0;29916
2022-03-23 21:30;27445;1210;520;0;0;29175
2022-03-23 22:30;25708;1410;519;0;0;27637
2022-03-23 23:30;25124;1397;519;0;0;27040
2022-03-24 00:30;23896;1530;521;0;0;25947
2022-03-24 01:30;22625;1555;517;0;0;24697
2022-03-24 02:30;22501;1583;519;0;0;24603
2022-03-24 03:30;22198;1617;518;0;0;24333
2022-03-24 04:30;22382;1610;518;0;0;24510
2022-03-24 05:30;24423;1756;517;0;0;26696
2022-03-24 06:30;27218;1745;517;0;0;29480
2022-03-24 07:30;28930;1896;515;0;0;31341
2022-03-24 08:30;28725;1950;514;0;0;31189
2022-03-24 09:30;28930;1784;508;1;0;31223
2022-03-24 10:30;28328;1562;506;1;0;30397
2022-03-24 11:30;27573;1676;505;1;0;29755
2022-03-24 12:30;27559;1625;510;0;0;29694
2022-03-24 13:30;27637;1621;509;2;0;29769
2022-03-24 14:30;27394;1530;512;1;0;29437
2022-03-24 15:30;27041;1749;511;0;0;29301
2022-03-24 16:30;27491;1902;513;1;0;29907
2022-03-24 17:30;28556;1895;512;0;0;30963
2022-03-24 18:30;28447;2145;511;0;0;31103
2022-03-24 19:30;28912;2272;512;0;0;31696
2022-03-24 20:30;28233;2233;514;0;0;30980
2022-03-24 21:30;27276;2256;512;0;0;30044
2022-03-24 22:30;26310;2244;515;0;0;29069
2022-03-24 23:30;24777;2088;514;0;0;27379
2022-03-25 00:30;23758;1891;515;0;0;26164
2022-03-25 01:30;23070;1809;513;0;0;25392
2022-03-25 02:30;22429;1778;513;0;0;24720
2022-03-25 03:30;22784;1586;516;0;0;24886
2022-03-25 04:30;22643;1404;516;0;0;24563
2022-03-25 05:30;24264;1300;515;0;0;26079
2022-03-25 06:30;26989;1221;513;0;0;28723
2022-03-25 07:30;29237;980;512;0;0;30729
2022-03-25 08:30;30311;873;511;0;0;31695
2022-03-25 09:30;30419;894;513;0;0;31826
2022-03-25 10:30;29805;905;511;1;0;31222
2022-03-25 11:30;29149;999;502;0;0;30650
2022-03-25 12:30;28101;1027;508;2;0;29638
2022-03-25 13:30;26872;1106;511;6;0;28495
2022-03-25 14:30;26268;1152;514;3;0;27937
2022-03-25 15:30;25760;1285;519;5;0;27569
2022-03-25 16:30;26559;1352;521;0;0;28432
2022-03-25 17:30;27688;1293;522;0;0;29503
2022-03-25 18:30;27984;1017;522;0;0;29523
2022-03-25 19:30;28167;907;525;0;0;29599
2022-03-25 20:30;28074;772;522;0;0;29368
2022-03-25 21:30;27599;624;522;0;0;28745
2022-03-25 22:30;25552;575;521;0;0;26648
2022-03-25 23:30;24930;577;523;0;0;26030
2022-03-26 00:30;24101;485;523;0;0;25109
2022-03-26 01:30;23670;472;510;0;0;24652
2022-03-26 02:30;23677;443;509;0;0;24629
2022-03-26 03:30;23558;430;506;0;0;24494
2022-03-26 04:30;23796;401;507;0;0;24704
2022-03-26 05:30;24716;390;504;0;0;25610
2022-03-26 06:30;25762;421;502;0;0;26685
2022-03-26 07:30;26096;429;504;0;269;27298
2022-03-26 08:30;25981;371;507;1;0;26860
2022-03-26 09:30;27371;325;503;2;0;28201
2022-03-26 10:30;26789;332;504;2;0;27627
2022-03-26 11:30;27173;308;504;0;0;27985
2022-03-26 12:30;27117;307;500;1;0;27925
2022-03-26 13:30;25725;294;501;4;0;26524
2022-03-26 14:30;25117;238;501;2;0;25858
2022-03-26 15:30;25075;179;502;3;0;25759
2022-03-26 16:30;25215;147;500;2;0;25864
2022-03-26 17:30;26767;114;503;0;0;27384
2022-03-26 18:30;27154;106;503;0;0;27763
2022-03-26 19:30;27644;126;504;0;0;28274
2022-03-26 20:30;27676;107;506;0;0;28289
2022-03-26 21:30;26375;157;508;0;0;27040
2022-03-26 22:30;25271;181;509;0;0;25961
2022-03-26 23:30;24188;255;508;0;0;24951
2022-03-27 00:30;23011;262;509;0;0;23782
2022-03-27 01:30;23122;230;506;0;0;23858
2022-03-27 02:30;22603;280;506;0;0;23389
2022-03-27 03:30;22766;273;505;0;0;23544
2022-03-27 04:30;23289;325;503;0;0;24117
2022-03-27 05:30;23819;272;505;0;0;24596
2022-03-27 06:30;25334;289;505;0;0;26128
2022-03-27 07:30;26429;351;506;0;0;27286
2022-03-27 08:30;27204;341;505;1;0;28051
2022-03-27 09:30;27552;327;505;2;0;28386
2022-03-27 10:30;26774;379;503;4;0;27660
2022-03-27 11:30;26383;425;504;6;0;27318
2022-03-27 12:30;26244;487;505;5;0;27241
2022-03-27 13:30;25679;534;518;4;0;26735
2022-03-27 14:30;25061;648;518;5;0;26232
2022-03-27 15:30;25011;757;523;4;0;26295
2022-03-27 16:30;26223;783;521;4;0;27531
2022-03-27 17:30;27539;785;522;3;0;28849
2022-03-27 18:30;29251;792;521;1;0;30565
2022-03-27 19:30;30005;884;522;0;0;31411
2022-03-27 20:30;30588;927;522;0;0;32037
2022-03-27 21:30;28797;969;523;0;0;30289
2022-03-27 22:30;28253;987;521;0;0;29761
2022-03-27 23:30;27516;912;519;0;0;28947
2022-03-28 00:30;26707;996;523;0;0;28226
2022-03-28 01:30;26930;931;520;0;0;28381
2022-03-28 02:30;27359;866;521;0;0;28746
2022-03-28 03:30;27807;826;520;0;0;29153
2022-03-28 04:30;28380;888;518;0;0;29786
2022-03-28 05:30;30209;803;519;0;0;31531
2022-03-28 06:30;31285;794;519;0;0;32598
2022-03-28 07:30;32697;790;517;0;0;34004
2022-03-28 08:30;32626;726;518;0;0;33870
2022-03-28 09:30;31499;684;515;1;0;32699
2022-03-28 10:30;30768;658;512;1;0;31939
2022-03-28 11:30;30173;731;518;1;0;31423
2022-03-28 12:30;29976;787;518;1;0;31282
2022-03-28 13:30;29357;837;508;1;0;30703
2022-03-28 14:30;29091;823;510;1;0;30425
2022-03-28 15:30;29091;924;514;1;0;30530
2022-03-28 16:30;29561;1048;513;1;0;31123
2022-03-28 17:30;30037;1283;508;1;0;31829
2022-03-28 18:30;30697;1516;512;0;0;32725
2022-03-28 19:30;31063;1745;512;0;0;33320
2022-03-28 20:30;30699;1921;508;0;0;33128
2022-03-28 21:30;30602;1984;506;0;0;33092
2022-03-28 22:30;30072;2189;506;0;0;32767
2022-03-28 23:30;29639;2246;506;0;0;32391
2022-03-29 00:30;27954;2271;505;0;0;30730
2022-03-29 01:30;26927;2276;507;0;0;29710
2022-03-29 02:30;26610;2368;508;0;0;29486
2022-03-29 03:30;26873;2431;507;0;0;29811
2022-03-29 04:30;27523;2093;505;0;0;30121
2022-03-29 05:30;29141;2075;504;0;0;31720
2022-03-29 06:30;30332;2101;500;0;0;32933
2022-03-29 07:30;31242;2186;499;0;0;33927
2022-03-29 08:30;31483;2246;498;0;0;34227
2022-03-29 09:30;31438;2319;498;0;0;34255
2022-03-29 10:30;31050;2194;498;1;0;33743
2022-03-29 11:30;29911;2249;501;1;0;32662
2022-03-29 12:30;29015;2305;500;1;0;31821
2022-03-29 13:30;27985;2388;513;1;0;30887
2022-03-29 14:30;27028;2467;511;1;0;30007
2022-03-29 15:30;26415;2509;511;8;0;29443
2022-03-29 16:30;27058;2629;510;5;0;30202
2022-03-29 17:30;28270;2595;513;2;0;31380
2022-03-29 18:30;28879;2590;514;1;0;31984
2022-03-29 19:30;29595;2648;514;0;0;32757
2022-03-29 20:30;29213;2653;517;0;0;32383
2022-03-29 21:30;28593;2601;517;0;0;31711
2022-03-29 22:30;27504;2584;517;0;0;30605
2022-03-29 23:30;26612;2548;517;0;0;29677
2022-03-30 00:30;25926;2500;517;0;0;28943
2022-03-30 01:30;25517;2422;517;0;0;28456
2022-03-30 02:30;25404;2367;516;0;0;28287
2022-03-30 03:30;25829;2239;516;0;0;28584
2022-03-30 04:30;26630;2192;518;0;0;29340
2022-03-30 05:30;28758;2262;518;0;0;31538
2022-03-30 06:30;29832;2145;517;0;0;32494
2022-03-30 07:30;30472;2011;516;0;0;32999
2022-03-30 08:30;29157;2004;516;4;0;31681
2022-03-30 09:30;29278;1666;519;7;0;31470
2022-03-30 10:30;28263;1604;517;8;0;30392
2022-03-30 11:30;27194;1719;519;9;0;29441
2022-03-30 12:30;26148;1778;518;8;0;28452
2022-03-30 13:30;25826;1827;528;8;0;28189
2022-03-30 14:30;25321;1707;533;7;0;27568
2022-03-30 15:30;24960;1551;535;8;0;27054
2022-03-30 16:30;26157;1390;533;4;0;28084
2022-03-30 17:30;27494;1499;531;1;0;29525
2022-03-30 18:30;28522;1424;530;0;0;30476
2022-03-30 19:30;28687;1452;533;0;0;30672
2022-03-30 20:30;28317;1535;535;0;0;30387
2022-03-30 21:30;27463;1482;539;0;0;29484
2022-03-30 22:30;25567;1230;544;0;0;27341
2022-03-30 23:30;24778;1060;545;0;0;26383
2022-03-31 00:30;24524;933;546;0;0;26003
2022-03-31 01:30;23835;925;550;0;0;25310
2022-03-31 02:30;23136;992;546;0;0;24674
2022-03-31 03:30;23262;869;545;0;0;24676
2022-03-31 04:30;23199;828;543;0;0;24570
2022-03-31 05:30;24789;844;541;0;0;26174
2022-03-31 06:30;28031;681;539;0;0;29251
2022-03-31 07:30;29281;673;537;0;0;30491
2022-03-31 08:30;28782;595;536;1;0;29914
2022-03-31 09:30;27885;625;536;4;0;29050
2022-03-31 10:30;27527;643;537;5;0;28712
2022-03-31 11:30;27203;780;533;1;0;28517
2022-03-31 12:30;26608;899;522;1;0;28030
2022-03-31 13:30;26331;1044;525;0;0;27900
2022-03-31 14:30;25596;1057;524;0;0;27177
2022-03-31 15:30;25259;1149;523;0;0;26931
2022-03-31 16:30;25515;1227;525;0;0;27267
2022-03-31 17:30;25636;1371;528;0;0;27535
2022-03-31 18:30;25778;1393;531;0;0;27702
2022-03-31 19:30;25841;1541;525;0;0;27907
2022-03-31 20:30;25628;1455;520;0;0;27603
2022-03-31 21:30;24374;1434;529;0;0;26337
2022-03-31 22:30;23186;2175;529;0;0;25890
2022-03-31 23:30;21879;2090;525;0;0;24494
2022-04-01 00:30;20383;2055;524;0;0;22962
2022-04-01 01:30;20205;2014;520;0;0;22739
2022-04-01 02:30;20321;2038;522;0;0;22881
2022-04-01 03:30;20343;1853;513;0;0;22709
2022-04-01 04:30;20705;1598;512;0;0;22815
2022-04-01 05:30;22530;1303;509;0;0;24342
2022-04-01 06:30;25756;1189;509;0;0;27454
2022-04-01 07:30;27750;1056;510;0;0;29316
2022-04-01 08:30;27605;770;511;2;0;28888
2022-04-01 09:30;27412;659;512;3;0;28586
2022-04-01 10:30;27696;639;511;1;0;28847
2022-04-01 11:30;27775;480;507;0;0;28762
2022-04-01 12:30;27512;431;508;1;0;28452
2022-04-01 13:30;26635;464;494;4;0;27597
2022-04-01 14:30;25455;518;495;4;0;26472
2022-04-01 15:30;25111;584;494;3;0;26192
2022-04-01 16:30;25489;692;497;2;0;26680
2022-04-01 17:30;26245;932;495;1;0;27673
2022-04-01 18:30;26964;1088;498;0;0;28550
2022-04-01 19:30;27724;1155;497;0;0;29376
2022-04-01 20:30;27294;1402;498;0;0;29194
2022-04-01 21:30;26562;1420;499;0;0;28481
2022-04-01 22:30;25465;1596;500;0;0;27561
2022-04-01 23:30;24577;1823;500;0;0;26900
2022-04-02 00:30;24042;1947;501;0;0;26490
2022-04-02 01:30;23848;2096;499;0;0;26443
2022-04-02 02:30;23555;2291;499;0;0;26345
2022-04-02 03:30;23855;2022;498;0;0;26375
2022-04-02 04:30;23772;2214;498;0;0;26484
2022-04-02 05:30;24858;2263;497;0;0;27618
2022-04-02 06:30;26383;2249;498;0;0;29130
2022-04-02 07:30;27138;2159;496;0;0;29793
2022-04-02 08:30;26974;2224;495;4;0;29697
2022-04-02 09:30;26208;2219;495;6;0;28928
2022-04-02 10:30;24630;2276;493;6;0;27405
2022-04-02 11:30;23867;2310;493;9;0;26679
2022-04-02 12:30;23203;2345;498;9;0;26055
2022-04-02 13:30;22321;2399;492;9;0;25221
2022-04-02 14:30;21294;2445;488;9;0;24236
2022-04-02 15:30;20106;2439;486;9;0;23040
2022-04-02 16:30;21791;2386;487;7;0;24671
2022-04-02 17:30;22362;2329;487;5;0;25183
2022-04-02 18:30;23434;2302;486;1;0;26223
2022-04-02 19:30;24554;2297;487;0;0;27338
2022-04-02 20:30;24534;2383;490;0;0;27407
2022-04-02 21:30;24167;2402;487;0;0;27056
2022-04-02 22:30;23835;2294;490;0;0;26619
2022-04-02 23:30;23417;2060;492;0;0;25969
2022-04-03 00:30;22612;1912;493;0;0;25017
2022-04-03 01:30;22853;1477;490;0;0;24820
2022-04-03 02:30;22973;1800;491;0;0;25264
2022-04-03 03:30;22553;1805;488;0;0;24846
2022-04-03 04:30;22739;1861;490;0;0;25090
2022-04-03 05:30;23135;1894;487;0;0;25516
2022-04-03 06:30;24559;1853;488;0;0;26900
2022-04-03 07:30;25527;1543;488;0;0;27558
2022-04-03 08:30;26209;1159;488;1;0;27857
2022-04-03 09:30;26332;895;488;1;0;27716
2022-04-03 10:30;26380;889;480;2;0;27751
2022-04-03 11:30;26145;931;480;3;0;27559
2022-04-03 12:30;25895;895;478;2;0;27270
2022-04-03 13:30;25287;896;471;2;0;26656
2022-04-03 14:30;25263;736;471;2;0;26472
2022-04-03 15:30;25326;693;471;2;0;26492
2022-04-03 16:30;25995;571;473;2;0;27041
2022-04-03 17:30;27038;463;473;2;0;27976
2022-04-03 18:30;27501;409;468;1;0;28379
2022-04-03 19:30;27670;509;466;0;0;28645
2022-04-03 20:30;27188;580;469;0;0;28237
2022-04-03 21:30;26597;677;473;0;0;27747
2022-04-03 22:30;25347;703;474;0;0;26524
2022-04-03 23:30;24507;652;473;0;0;25632
2022-04-04 00:30;24305;646;475;0;0;25426
2022-04-04 01:30;24119;739;475;0;0;25333
2022-04-04 02:30;23756;829;474;0;0;25059
2022-04-04 03:30;24144;795;476;0;0;25415
2022-04-04 04:30;25133;785;478;0;0;26396
2022-04-04 05:30;26834;775;478;0;0;28087
2022-04-04 06:30;28240;718;474;0;0;29432
2022-04-04 07:30;28667;609;473;1;0;29750
2022-04-04 08:30;26621;422;476;4;0;27523
2022-04-04 09:30;26295;519;474;7;0;27295
2022-04-04 10:30;25575;949;472;9;0;27005
2022-04-04 11:30;25238;1180;472;9;0;26899
2022-04-04 12:30;25077;1242;474;9;0;26802
2022-04-04 13:30;24543;1333;486;9;0;26371
2022-04-04 14:30;24157;1287;488;9;0;25941
2022-04-04 15:30;23941;1299;485;8;0;25733
2022-04-04 16:30;24104;1396;482;4;0;25986
2022-04-04 17:30;25018;1432;482;3;0;26935
2022-04-04 18:30;25380;1341;483;0;0;27204
2022-04-04 19:30;26169;1374;482;0;0;28025
2022-04-04 20:30;26270;1537;482;0;0;28289
2022-04-04 21:30;25220;1653;479;0;0;27352
2022-04-04 22:30;23985;1610;476;0;0;26071
2022-04-04 23:30;22996;1589;478;0;0;25063
2022-04-05 00:30;22230;1492;480;0;0;24202
2022-04-05 01:30;21857;1213;482;0;0;23552
2022-04-05 02:30;22165;1115;481;0;0;23761
2022-04-05 03:30;22493;1110;482;0;0;24085
2022-04-05 04:30;23926;1112;480;0;0;25518
2022-04-05 05:30;25623;1185;481;0;0;27289
2022-04-05 06:30;26729;1260;482;0;0;28471
2022-04-05 07:30;27205;1194;480;1;0;28880
2022-04-05 08:30;25709;1082;480;4;0;27275
2022-04-05 09:30;25597;1211;480;7;0;27295
2022-04-05 10:30;24867;1314;474;9;0;26664
2022-04-05 11:30;24263;1341;474;9;0;26087
2022-04-05 12:30;23707;1387;476;8;0;25578
2022-04-05 13:30;23789;1315;470;8;0;25582
2022-04-05 14:30;22996;1375;473;8;0;24852
2022-04-05 15:30;23169;1371;473;8;0;25021
2022-04-05 16:30;23484;1319;474;6;0;25283
2022-04-05 17:30;24470;1143;478;3;0;26094
2022-04-05 18:30;25063;900;478;1;0;26442
2022-04-05 19:30;25745;899;477;0;0;27121
2022-04-05 20:30;25754;1063;476;0;0;27293
2022-04-05 21:30;25006;1155;478;0;0;26639
2022-04-05 22:30;23383;1020;471;0;0;24874
2022-04-05 23:30;22937;876;473;0;0;24286
2022-04-06 00:30;21639;738;472;0;0;22849
2022-04-06 01:30;21060;600;473;0;0;22133
2022-04-06 02:30;21657;545;473;0;0;22675
2022-04-06 03:30;21695;618;470;0;0;22783
2022-04-06 04:30;22616;582;471;0;0;23669
2022-04-06 05:30;24683;578;473;0;0;25734
2022-04-06 06:30;27811;711;466;0;0;28988
2022-04-06 07:30;28344;721;465;0;0;29530
2022-04-06 08:30;26916;646;467;4;0;28033
2022-04-06 09:30;26220;605;471;7;0;27303
2022-04-06 10:30;24812;651;471;9;0;25943
2022-04-06 11:30;24573;597;471;9;0;25650
2022-04-06 12:30;24042;497;473;9;0;25021
2022-04-06 13:30;23712;494;470;9;0;24685
2022-04-06 14:30;23069;442;467;9;0;23987
2022-04-06 15:30;22829;472;468;9;0;23778
2022-04-06 16:30;22903;382;468;7;0;23760
2022-04-06 17:30;24595;361;468;4;0;25428
2022-04-06 18:30;24557;358;468;1;0;25384
2022-04-06 19:30;25058;515;468;0;0;26041
2022-04-06 20:30;24967;711;468;0;0;26146
2022-04-06 21:30;24221;852;468;0;0;25541
2022-04-06 22:30;23028;998;469;0;0;24495
2022-04-06 23:30;21863;1181;475;0;0;23519
2022-04-07 00:30;20750;1159;474;0;0;22383
2022-04-07 01:30;20401;1152;474;0;0;22027
2022-04-07 02:30;20013;1104;473;0;0;21590
2022-04-07 03:30;20001;1118;472;0;0;21591
2022-04-07 04:30;20450;1020;474;0;0;21944
2022-04-07 05:30;22574;1073;473;0;0;24120
2022-04-07 06:30;25415;1044;476;0;0;26935
2022-04-07 07:30;27349;1089;473;0;0;28911
2022-04-07 08:30;27786;1020;472;0;0;29278
2022-04-07 09:30;27253;947;474;1;0;28675
2022-04-07 10:30;26621;888;473;1;0;27983
2022-04-07 11:30;26412;1067;468;1;0;27948
2022-04-07 12:30;26209;1089;469;1;0;27768
2022-04-07 13:30;26259;1151;469;1;0;27880
2022-04-07 14:30;26087;1313;469;1;0;27870
2022-04-07 15:30;25078;1510;472;1;0;27061
2022-04-07 16:30;26412;1548;467;0;0;28427
2022-04-07 17:30;27009;1883;473;0;0;29365
2022-04-07 18:30;26972;2007;474;0;0;29453
2022-04-07 19:30;26767;2270;471;0;0;29508
2022-04-07 20:30;25525;2393;476;0;0;28394
2022-04-07 21:30;25488;2442;478;0;0;28408
2022-04-07 22:30;24512;2495;479;0;0;27486
2022-04-07 23:30;23394;2465;479;0;0;26338
2022-04-08 00:30;23280;2402;478;0;0;26160
2022-04-08 01:30;22733;2516;477;0;0;25726
2022-04-08 02:30;22374;2681;477;0;0;25532
2022-04-08 03:30;22753;2598;477;0;0;25828
2022-04-08 04:30;23099;2718;477;0;0;26294
2022-04-08 05:30;24731;2445;477;0;0;27653
2022-04-08 06:30;26945;2178;475;0;0;29598
2022-04-08 07:30;28375;2340;475;0;0;31190
2022-04-08 08:30;28071;2372;476;0;0;30919
2022-04-08 09:30;27494;2401;477;1;0;30373
2022-04-08 10:30;26777;2933;475;1;0;30186
2022-04-08 11:30;26278;2253;478;4;0;29013
2022-04-08 12:30;26469;2125;471;3;0;29068
2022-04-08 13:30;25823;2097;471;2;0;28393
2022-04-08 14:30;25825;2359;470;4;0;28658
2022-04-08 15:30;25051;1847;468;3;0;27369
2022-04-08 16:30;26021;1963;467;1;0;28452
2022-04-08 17:30;26487;1762;465;1;0;28715
2022-04-08 18:30;26486;1663;467;1;0;28617
2022-04-08 19:30;27047;1562;468;0;0;29077
2022-04-08 20:30;26814;1451;469;0;0;28734
2022-04-08 21:30;26397;1370;470;0;0;28237
2022-04-08 22:30;25670;1127;476;0;0;27273
2022-04-08 23:30;24418;1108;476;0;0;26002
2022-04-09 00:30;23652;1161;475;0;0;25288
2022-04-09 01:30;23164;1002;474;0;0;24640
2022-04-09 02:30;23261;937;474;0;0;24672
2022-04-09 03:30;23110;734;474;0;0;24318
2022-04-09 04:30;23372;636;471;0;0;24479
2022-04-09 05:30;24700;481;470;0;0;25651
2022-04-09 06:30;25826;278;471;0;0;26575
2022-04-09 07:30;26917;213;473;0;0;27603
2022-04-09 08:30;27074;231;474;1;0;27780
2022-04-09 09:30;26341;242;476;1;0;27060
2022-04-09 10:30;26692;244;475;1;0;27412
2022-04-09 11:30;26747;284;474;2;0;27507
2022-04-09 12:30;25265;223;489;1;0;25978
2022-04-09 13:30;25447;154;491;1;0;26093
2022-04-09 14:30;24945;103;489;1;0;25538
2022-04-09 15:30;25209;94;489;1;0;25793
2022-04-09 16:30;25596;90;487;1;0;26174
2022-04-09 17:30;26059;75;488;1;0;26623
2022-04-09 18:30;26218;134;491;1;0;26844
2022-04-09 19:30;26763;161;490;0;0;27414
2022-04-09 20:30;26599;216;491;0;0;27306
2022-04-09 21:30;25569;293;490;0;0;26352
2022-04-09 22:30;24741;440;488;0;0;25669
2022-04-09 23:30;24193;461;491;0;0;25145
2022-04-10 00:30;23705;568;491;0;0;24764
2022-04-10 01:30;23083;567;491;0;0;24141
2022-04-10 02:30;22581;607;491;0;0;23679
2022-04-10 03:30;22126;599;490;0;0;23215
2022-04-10 04:30;22499;669;489;0;0;23657
2022-04-10 05:30;23256;694;487;0;0;24437
2022-04-10 06:30;24263;751;489;0;0;25503
2022-04-10 07:30;24649;859;490;0;0;25998
2022-04-10 08:30;25475;834;488;1;0;26798
2022-04-10 09:30;25765;788;487;1;0;27041
2022-04-10 10:30;25595;677;487;3;0;26762
2022-04-10 11:30;25400;669;489;4;0;26562
2022-04-10 12:30;24750;794;490;5;0;26039
2022-04-10 13:30;23827;967;493;6;0;25293
2022-04-10 14:30;23223;1017;492;8;0;24740
2022-04-10 15:30;23198;1077;491;6;0;24772
2022-04-10 16:30;23324;1198;489;1;0;25012
2022-04-10 17:30;24679;1257;489;2;0;26427
2022-04-10 18:30;25596;1226;492;0;0;27314
2022-04-10 19:30;26037;1374;492;0;0;27903
2022-04-10 20:30;25868;1523;494;0;0;27885
2022-04-10 21:30;25193;1619;498;0;0;27310
2022-04-10 22:30;23968;1781;496;0;0;26245
2022-04-10 23:30;22636;1866;496;0;0;24998
2022-04-11 00:30;21645;1837;491;0;0;23973
2022-04-11 01:30;21630;1738;493;0;0;23861
2022-04-11 02:30;21234;1545;492;0;0;23271
2022-04-11 03:30;21330;1454;492;0;0;23276
2022-04-11 04:30;22144;1387;492;0;0;24023
2022-04-11 05:30;23760;1531;491;0;0;25782
2022-04-11 06:30;26671;1479;491;0;0;28641
2022-04-11 07:30;26694;1340;492;1;0;28527
2022-04-11 08:30;25664;1410;490;4;0;27568
2022-04-11 09:30;25052;1397;486;7;0;26942
2022-04-11 10:30;23728;1441;486;9;0;25664
2022-04-11 11:30;23880;1619;487;9;0;25995
2022-04-11 12:30;23337;1609;488;9;0;25443
2022-04-11 13:30;22259;1746;506;9;0;24520
2022-04-11 14:30;21424;1693;505;9;0;23631
2022-04-11 15:30;21552;1477;504;5;0;23538
2022-04-11 16:30;22544;1160;503;4;0;24211
2022-04-11 17:30;23562;926;504;4;0;24996
2022-04-11 18:30;23971;620;505;1;0;25097
2022-04-11 19:30;24907;508;505;0;0;25920
2022-04-11 20:30;25400;599;506;0;0;26505
2022-04-11 21:30;24191;560;507;0;0;25258
2022-04-11 22:30;22412;936;508;0;0;23856
2022-04-11 23:30;20508;953;506;0;0;21967
2022-04-12 00:30;19294;1137;506;0;0;20937
2022-04-12 01:30;18786;1215;504;0;0;20505
2022-04-12 02:30;19242;1071;504;0;0;20817
2022-04-12 03:30;19712;942;502;0;0;21156
2022-04-12 04:30;20085;891;502;0;0;21478
2022-04-12 05:30;21866;839;502;0;0;23207
2022-04-12 06:30;24489;746;501;0;0;25736
2022-04-12 07:30;25696;718;502;0;0;26916
2022-04-12 08:30;24986;672;501;2;0;26161
2022-04-12 09:30;23932;573;500;4;0;25009
2022-04-12 10:30;23815;479;498;9;0;24801
2022-04-12 11:30;23613;478;498;9;0;24598
2022-04-12 12:30;22678;896;504;9;0;24087
2022-04-12 13:30;22254;1094;514;9;0;23871
2022-04-12 14:30;21323;1191;515;9;0;23038
2022-04-12 15:30;20981;1380;512;9;0;22882
2022-04-12 16:30;21355;1510;514;7;0;23386
2022-04-12 17:30;22330;1548;512;5;0;24395
2022-04-12 18:30;22370;1428;514;1;0;24313
2022-04-12 19:30;23479;1291;515;0;0;25285
2022-04-12 20:30;23599;1444;510;0;0;25553
2022-04-12 21:30;22533;1482;513;0;0;24528
2022-04-12 22:30;21085;1504;515;0;0;23104
2022-04-12 23:30;19682;1477;514;0;0;21673
2022-04-13 00:30;18821;1306;516;0;0;20643
2022-04-13 01:30;18457;1154;513;0;0;20124
2022-04-13 02:30;18679;1228;513;0;0;20420
2022-04-13 03:30;18492;1351;515;0;0;20358
2022-04-13 04:30;19166;1493;516;0;0;21175
2022-04-13 05:30;20479;1313;516;0;0;22308
2022-04-13 06:30;22305;1116;516;0;0;23937
2022-04-13 07:30;23543;835;514;0;0;24892
2022-04-13 08:30;24466;513;513;1;0;25493
2022-04-13 09:30;23455;485;513;3;0;24456
2022-04-13 10:30;23615;435;512;1;0;24563
2022-04-13 11:30;23812;555;508;2;0;24877
2022-04-13 12:30;23052;551;516;1;0;24120
2022-04-13 13:30;22908;516;519;0;0;23943
2022-04-13 14:30;22652;575;518;0;0;23745
2022-04-13 15:30;23031;520;517;0;0;24068
2022-04-13 16:30;23852;440;519;0;0;24811
2022-04-13 17:30;24780;370;517;0;0;25667
2022-04-13 18:30;25288;347;518;0;0;26153
2022-04-13 19:30;25205;474;519;0;0;26198
2022-04-13 20:30;24776;505;519;0;0;25800
2022-04-13 21:30;23771;534;517;0;0;24822
2022-04-13 22:30;22082;617;518;0;0;23217
2022-04-13 23:30;20812;667;519;0;0;21998
2022-04-14 00:30;19957;700;518;0;0;21175
2022-04-14 01:30;19541;773;518;0;0;20832
2022-04-14 02:30;19173;822;518;0;0;20513
2022-04-14 03:30;19056;879;520;0;0;20455
2022-04-14 04:30;19433;1057;519;0;0;21009
2022-04-14 05:30;20461;1290;518;0;0;22269
2022-04-14 06:30;22292;1485;519;0;0;24296
2022-04-14 07:30;23884;1477;519;0;0;25880
2022-04-14 08:30;24371;1385;521;1;0;26278
2022-04-14 09:30;23694;1390;516;1;0;25601
2022-04-14 10:30;23663;1418;506;1;0;25588
2022-04-14 11:30;23623;1456;510;1;0;25590
2022-04-14 12:30;23145;1543;519;1;0;25208
2022-04-14 13:30;22721;1639;533;2;0;24895
2022-04-14 14:30;21895;1665;528;4;0;24092
2022-04-14 15:30;21369;1764;533;4;0;23670
2022-04-14 16:30;21716;1802;534;3;0;24055
2022-04-14 17:30;22286;1955;536;0;0;24777
2022-04-14 18:30;22501;2080;538;0;0;25119
2022-04-14 19:30;22631;2133;538;0;0;25302
2022-04-14 20:30;22193;2133;539;0;0;24865
2022-04-14 21:30;21427;2053;540;0;0;24020
2022-04-14 22:30;20839;2038;543;0;0;23420
2022-04-14 23:30;19351;2053;544;0;0;21948
2022-04-15 00:30;18474;2142;540;0;0;21156
2022-04-15 01:30;18112;2280;540;0;0;20932
2022-04-15 02:30;17709;2228;540;0;0;20477
2022-04-15 03:30;18546;1707;540;0;0;20793
2022-04-15 04:30;19493;1291;538;0;0;21322
2022-04-15 05:30;20558;1099;536;0;0;22193
2022-04-15 06:30;22059;1049;537;0;0;23645
2022-04-15 07:30;22672;978;538;1;0;24189
2022-04-15 08:30;22904;745;539;4;0;24192
2022-04-15 09:30;22943;718;540;7;0;24208
2022-04-15 10:30;22051;983;537;9;0;23580
2022-04-15 11:30;21611;1035;537;9;0;23192
2022-04-15 12:30;20634;1396;545;9;0;22584
2022-04-15 13:30;19973;1379;582;7;0;21941
2022-04-15 14:30;19552;1460;581;4;0;21597
2022-04-15 15:30;19235;1477;577;8;0;21297
2022-04-15 16:30;19214;1592;580;4;0;21390
2022-04-15 17:30;20029;1457;578;1;0;22065
2022-04-15 18:30;20531;1043;582;1;0;22157
2022-04-15 19:30;20515;1390;582;0;0;22487
2022-04-15 20:30;20973;1337;581;0;0;22891
2022-04-15 21:30;19748;1513;581;0;0;21842
2022-04-15 22:30;18681;1989;583;0;0;21253
2022-04-15 23:30;17717;2390;584;0;0;20691
2022-04-16 00:30;16753;2465;585;0;0;19803
2022-04-16 01:30;16875;2416;583;0;0;19874
2022-04-16 02:30;16934;2453;582;0;0;19969
2022-04-16 03:30;17042;2264;583;0;0;19889
2022-04-16 04:30;17479;2592;582;0;0;20653
2022-04-16 05:30;18228;2570;579;0;0;21377
2022-04-16 06:30;19476;2672;580;0;0;22728
2022-04-16 07:30;20550;2580;580;1;0;23711
2022-04-16 08:30;21152;2762;579;1;0;24494
2022-04-16 09:30;21257;2786;580;4;0;24627
2022-04-16 10:30;20816;2349;581;8;0;23754
2022-04-16 11:30;20533;2594;579;5;0;23711
2022-04-16 12:30;20370;2338;578;6;0;23292
2022-04-16 13:30;19695;1827;548;7;0;22077
2022-04-16 14:30;19158;1754;550;6;0;21468
2022-04-16 15:30;19704;1739;547;7;0;21997
2022-04-16 16:30;20194;1430;550;4;0;22178
2022-04-16 17:30;21228;959;550;3;0;22740
2022-04-16 18:30;22016;668;552;2;0;23238
2022-04-16 19:30;23084;441;551;0;0;24076
2022-04-16 20:30;23575;341;554;0;0;24470
2022-04-16 21:30;23206;389;554;0;0;24149
2022-04-16 22:30;22132;379;552;0;0;23063
2022-04-16 23:30;21299;339;553;0;0;22191
2022-04-17 00:30;21164;250;552;0;0;21966
2022-04-17 01:30;21134;168;553;0;0;21855
2022-04-17 02:30;21134;187;553;0;0;21874
2022-04-17 03:30;21039;302;552;0;0;21893
2022-04-17 04:30;21584;393;551;0;0;22528
2022-04-17 05:30;22202;417;551;0;0;23170
2022-04-17 06:30;22632;474;551;0;0;23657
2022-04-17 07:30;23511;425;551;1;0;24488
2022-04-17 08:30;23386;471;548;1;0;24406
2022-04-17 09:30;23401;666;551;6;0;24624
2022-04-17 10:30;22975;884;554;4;0;24417
2022-04-17 11:30;22311;1363;555;9;0;24238
2022-04-17 12:30;21718;1588;594;8;0;23908
2022-04-17 13:30;21347;1708;596;5;0;23656
2022-04-17 14:30;20793;1834;599;5;0;23231
2022-04-17 15:30;20674;1868;599;2;0;23143
2022-04-17 16:30;20384;2019;596;1;0;23000
2022-04-17 17:30;20907;2121;595;2;0;23625
2022-04-17 18:30;21074;2462;599;1;0;24136
2022-04-17 19:30;21649;2608;599;0;0;24856
2022-04-17 20:30;22643;2649;597;0;0;25889
2022-04-17 21:30;22117;2867;597;0;0;25581
2022-04-17 22:30;21109;2504;598;0;0;24211
2022-04-17 23:30;19586;2498;596;0;0;22680
2022-04-18 00:30;19143;2345;596;0;0;22084
2022-04-18 01:30;19042;2193;595;0;0;21830
2022-04-18 02:30;19204;2069;596;0;0;21869
2022-04-18 03:30;19522;1890;596;0;0;22008
2022-04-18 04:30;20501;2247;594;0;0;23342
2022-04-18 05:30;22642;2160;596;0;0;25398
2022-04-18 06:30;24132;1822;594;0;0;26548
2022-04-18 07:30;24857;1384;594;1;0;26836
2022-04-18 08:30;24912;1462;594;5;0;26973
2022-04-18 09:30;24605;1164;597;7;0;26373
2022-04-18 10:30;24373;974;593;9;0;25949
2022-04-18 11:30;23819;855;595;9;0;25278
2022-04-18 12:30;23302;728;617;9;0;24656
2022-04-18 13:30;22859;521;620;9;0;24009
2022-04-18 14:30;22709;412;620;9;0;23750
2022-04-18 15:30;22997;261;620;8;0;23886
2022-04-18 16:30;23256;207;618;6;0;24087
2022-04-18 17:30;25278;127;619;3;0;26027
2022-04-18 18:30;25634;201;620;1;0;26456
2022-04-18 19:30;25963;524;621;0;0;27108
2022-04-18 20:30;25388;1112;620;0;0;27120
2022-04-18 21:30;23750;1635;620;0;0;26005
2022-04-18 22:30;21743;2023;621;0;0;24387
2022-04-18 23:30;19503;2465;619;0;0;22587
2022-04-19 00:30;18132;2233;622;0;0;20987
2022-04-19 01:30;17505;2807;621;0;0;20933
2022-04-19 02:30;17394;2792;620;0;0;20806
2022-04-19 03:30;17449;2817;620;0;0;20886
2022-04-19 04:30;18600;3002;620;0;0;22222
2022-04-19 05:30;20868;2593;620;0;0;24081
2022-04-19 06:30;24171;3031;619;0;0;27821
2022-04-19 07:30;25215;2658;617;0;0;28490
2022-04-19 08:30;26327;2718;614;0;5;29664
2022-04-19 09:30;26181;2688;610;1;0;29480
2022-04-19 10:30;25739;2733;608;1;182;29263
2022-04-19 11:30;24496;2655;604;3;0;27758
2022-04-19 12:30;23486;2728;608;3;0;26825
2022-04-19 13:30;23017;2738;611;2;0;26368
2022-04-19 14:30;22578;2690;610;2;0;25880
2022-04-19 15:30;22501;2639;610;6;0;25756
2022-04-19 16:30;22823;2692;610;3;0;26128
2022-04-19 17:30;23754;2654;610;3;0;27021
2022-04-19 18:30;24232;2504;610;0;0;27346
2022-04-19 19:30;24876;2291;609;0;0;27776
2022-04-19 20:30;24829;2237;610;0;0;27676
2022-04-19 21:30;23206;2712;611;0;0;26529
2022-04-19 22:30;21830;2650;611;0;0;25091
2022-04-19 23:30;20728;2785;610;0;0;24123
2022-04-20 00:30;19937;2688;609;0;0;23234
2022-04-20 01:30;19791;2694;607;0;0;23092
2022-04-20 02:30;19601;2606;607;0;0;22814
2022-04-20 03:30;19522;2645;606;0;0;22773
2022-04-20 04:30;19980;2731;606;0;0;23317
2022-04-20 05:30;21808;2870;606;0;0;25284
2022-04-20 06:30;24757;2631;605;0;0;27993
2022-04-20 07:30;26966;3047;604;0;0;30617
2022-04-20 08:30;26583;2993;606;2;0;30184
2022-04-20 09:30;25519;3025;606;3;0;29153
2022-04-20 10:30;24307;2711;607;3;0;27628
2022-04-20 11:30;23991;2722;605;5;0;27323
2022-04-20 12:30;23567;2765;605;6;0;26943
2022-04-20 13:30;22600;2729;619;8;0;25956
2022-04-20 14:30;22188;2781;618;7;0;25594
2022-04-20 15:30;21588;2845;617;9;0;25059
2022-04-20 16:30;22175;2748;619;8;0;25550
2022-04-20 17:30;22708;2678;619;5;0;26010
2022-04-20 18:30;23485;2607;620;1;0;26713
2022-04-20 19:30;24237;2529;620;0;0;27386
2022-04-20 20:30;24882;2274;619;0;0;27775
2022-04-20 21:30;23630;2123;621;0;0;26374
2022-04-20 22:30;21892;1912;622;0;0;24426
2022-04-20 23:30;20350;1704;622;0;0;22676
2022-04-21 00:30;19859;1740;622;0;0;22221
2022-04-21 01:30;19876;1504;621;0;0;22001
2022-04-21 02:30;20262;1500;622;0;0;22384
2022-04-21 03:30;20538;1343;621;0;0;22502
2022-04-21 04:30;21465;1113;620;0;0;23198
2022-04-21 05:30;23163;1038;618;0;0;24819
2022-04-21 06:30;24672;1169;620;0;0;26461
2022-04-21 07:30;25648;1057;621;1;0;27327
2022-04-21 08:30;25475;1029;619;2;0;27125
2022-04-21 09:30;25251;1023;622;2;0;26898
2022-04-21 10:30;24553;1181;616;2;0;26352
2022-04-21 11:30;23328;1372;619;3;0;25322
2022-04-21 12:30;23329;1549;622;0;0;25500
2022-04-21 13:30;22976;1775;622;0;0;25373
2022-04-21 14:30;22156;2041;622;0;0;24819
2022-04-21 15:30;21977;2203;623;0;0;24803
2022-04-21 16:30;21825;2380;624;0;0;24829
2022-04-21 17:30;23150;2699;625;0;0;26474
2022-04-21 18:30;23245;2865;625;0;0;26735
2022-04-21 19:30;22842;2861;623;0;0;26326
2022-04-21 20:30;22633;3098;624;0;0;26355
2022-04-21 21:30;21695;2489;622;0;0;24806
2022-04-21 22:30;19947;2419;624;0;0;22990
2022-04-21 23:30;18104;2577;625;0;0;21306
2022-04-22 00:30;17407;2565;626;0;0;20598
2022-04-22 01:30;16975;2479;625;0;0;20079
2022-04-22 02:30;17018;2715;624;0;0;20357
2022-04-22 03:30;17433;2561;624;0;0;20618
2022-04-22 04:30;18309;2477;624;0;0;21410
2022-04-22 05:30;19918;2398;624;0;0;22940
2022-04-22 06:30;22492;2351;623;0;0;25466
2022-04-22 07:30;23904;2320;624;0;0;26848
2022-04-22 08:30;24066;2323;621;0;0;27010
2022-04-22 09:30;23083;2575;621;7;0;26286
2022-04-22 10:30;22509;2667;621;9;0;25806
2022-04-22 11:30;21866;2447;616;9;0;24938
2022-04-22 12:30;21437;2683;604;4;0;24728
2022-04-22 13:30;20797;2895;576;3;0;24271
2022-04-22 14:30;20382;2447;577;6;0;23412
2022-04-22 15:30;19572;2484;577;7;0;22640
2022-04-22 16:30;19717;2651;575;4;0;22947
2022-04-22 17:30;20235;2694;574;5;0;23508
2022-04-22 18:30;21069;2594;576;1;0;24240
2022-04-22 19:30;21291;2647;576;0;0;24514
2022-04-22 20:30;22032;2612;580;0;0;25224
2022-04-22 21:30;21299;2612;581;0;0;24492
2022-04-22 22:30;20361;2617;579;0;0;23557
2022-04-22 23:30;18871;2633;578;0;0;22082
2022-04-23 00:30;17556;2586;577;0;0;20719
2022-04-23 01:30;17267;2505;580;0;0;20352
2022-04-23 02:30;17468;2361;579;0;0;20408
2022-04-23 03:30;18007;2204;578;0;0;20789
2022-04-23 04:30;18654;2346;577;0;0;21577
2022-04-23 05:30;19469;2362;579;0;0;22410
2022-04-23 06:30;20945;1723;580;0;0;23248
2022-04-23 07:30;21352;1536;579;1;0;23468
2022-04-23 08:30;21835;1694;578;4;0;24111
2022-04-23 09:30;21981;1616;578;6;0;24181
2022-04-23 10:30;21655;1620;581;8;0;23864
2022-04-23 11:30;21322;1771;582;8;0;23683
2022-04-23 12:30;20916;1804;585;7;0;23312
2022-04-23 13:30;20239;1843;584;7;0;22673
2022-04-23 14:30;19244;1892;589;8;0;21733
2022-04-23 15:30;18739;1587;590;8;0;20924
2022-04-23 16:30;18793;1548;589;5;0;20935
2022-04-23 17:30;19337;1466;592;5;0;21400
2022-04-23 18:30;19926;1329;594;1;0;21850
2022-04-23 19:30;20253;1594;596;0;0;22443
2022-04-23 20:30;20349;1816;600;0;0;22765
2022-04-23 21:30;19674;2032;598;0;0;22304
2022-04-23 22:30;18522;2077;599;0;0;21198
2022-04-23 23:30;18202;1918;597;0;0;20717
2022-04-24 00:30;17774;1898;599;0;0;20271
2022-04-24 01:30;17717;1811;598;0;0;20126
2022-04-24 02:30;18174;1633;597;0;0;20404
2022-04-24 03:30;18414;1598;596;0;0;20608
2022-04-24 04:30;18685;1541;596;0;0;20822
2022-04-24 05:30;19877;1521;596;0;0;21994
2022-04-24 06:30;20902;1374;597;0;0;22873
2022-04-24 07:30;21504;1366;599;0;0;23469
2022-04-24 08:30;22254;1339;599;1;0;24193
2022-04-24 09:30;22893;1140;599;3;0;24635
2022-04-24 10:30;22498;1024;598;4;0;24124
2022-04-24 11:30;21985;1002;595;7;0;23589
2022-04-24 12:30;21674;904;620;8;0;23206
2022-04-24 13:30;21166;814;619;5;0;22604
2022-04-24 14:30;20641;632;620;7;0;21900
2022-04-24 15:30;20730;582;620;4;0;21936
2022-04-24 16:30;21148;470;620;3;0;22241
2022-04-24 17:30;21780;477;615;2;0;22874
2022-04-24 18:30;21886;438;618;1;0;22943
2022-04-24 19:30;22081;694;620;0;0;23395
2022-04-24 20:30;21570;1067;622;0;0;23259
2022-04-24 21:30;20759;1447;622;0;0;22828
2022-04-24 22:30;19236;1687;623;0;0;21546
2022-04-24 23:30;18336;1739;623;0;0;20698
2022-04-25 00:30;17324;1657;620;0;0;19601
2022-04-25 01:30;17414;1513;618;0;0;19545
2022-04-25 02:30;17625;1450;620;0;0;19695
2022-04-25 03:30;17838;1598;620;0;0;20056
2022-04-25 04:30;18575;1499;618;0;0;20692
2022-04-25 05:30;19431;1611;618;0;0;21660
2022-04-25 06:30;21488;1809;620;0;0;23917
2022-04-25 07:30;22663;1852;619;1;0;25135
2022-04-25 08:30;23807;1565;621;1;0;25994
2022-04-25 09:30;23744;1234;618;6;0;25602
2022-04-25 10:30;22626;1249;614;7;0;24496
2022-04-25 11:30;22610;1162;618;6;0;24396
2022-04-25 12:30;22682;1112;624;0;0;24418
2022-04-25 13:30;22292;1266;595;3;0;24156
2022-04-25 14:30;21747;1165;594;6;0;23512
2022-04-25 15:30;21604;1208;594;6;0;23412
2022-04-25 16:30;21900;1375;595;3;0;23873
2022-04-25 17:30;22560;1644;595;1;0;24800
2022-04-25 18:30;22515;1851;596;0;0;24962
2022-04-25 19:30;22268;2173;597;0;0;25038
2022-04-25 20:30;21661;2436;595;0;0;24692
2022-04-25 21:30;20176;2135;596;0;0;22907
2022-04-25 22:30;17864;2632;602;0;0;21098
2022-04-25 23:30;15796;2721;602;0;0;19119
2022-04-26 00:30;14993;2803;602;0;0;18398
2022-04-26 01:30;15014;2829;604;0;0;18447
2022-04-26 02:30;14857;2439;603;0;0;17899
2022-04-26 03:30;15074;2278;603;0;0;17955
2022-04-26 04:30;15537;2549;604;0;0;18690
2022-04-26 05:30;16849;2676;602;0;0;20127
2022-04-26 06:30;19409;2643;602;0;0;22654
2022-04-26 07:30;21279;2624;603;1;0;24507
2022-04-26 08:30;22297;2537;602;2;0;25438
2022-04-26 09:30;22027;2249;603;3;0;24882
2022-04-26 10:30;21509;2006;599;5;0;24119
2022-04-26 11:30;21256;1834;603;8;0;23701
2022-04-26 12:30;21317;1634;608;6;0;23565
2022-04-26 13:30;21143;1486;630;3;0;23262
2022-04-26 14:30;20586;1388;632;2;0;22608
2022-04-26 15:30;20993;1414;631;2;0;23040
2022-04-26 16:30;21118;1205;629;2;0;22954
2022-04-26 17:30;22519;961;630;1;0;24111
2022-04-26 18:30;22892;959;630;0;0;24481
2022-04-26 19:30;23233;906;629;0;0;24768
2022-04-26 20:30;22996;860;632;0;0;24488
2022-04-26 21:30;22013;855;632;0;0;23500
2022-04-26 22:30;20685;806;629;0;0;22120
2022-04-26 23:30;18994;568;626;0;0;20188
2022-04-27 00:30;18691;434;626;0;0;19751
2022-04-27 01:30;18484;439;629;0;0;19552
2022-04-27 02:30;18612;366;629;0;0;19607
2022-04-27 03:30;19118;272;626;0;0;20016
2022-04-27 04:30;19313;203;624;0;0;20140
2022-04-27 05:30;20310;235;623;0;0;21168
2022-04-27 06:30;23155;233;621;0;0;24009
2022-04-27 07:30;24372;223;622;0;0;25217
2022-04-27 08:30;24793;148;625;1;0;25567
2022-04-27 09:30;24145;125;626;1;0;24897
2022-04-27 10:30;23965;155;623;1;0;24744
2022-04-27 11:30;23928;176;620;2;0;24726
2022-04-27 12:30;23353;237;580;1;0;24171
2022-04-27 13:30;23330;350;585;1;0;24266
2022-04-27 14:30;22659;526;578;2;0;23765
2022-04-27 15:30;22756;748;582;2;0;24088
2022-04-27 16:30;23545;803;584;1;0;24933
2022-04-27 17:30;23963;926;583;1;0;25473
2022-04-27 18:30;24185;1061;582;1;0;25829
2022-04-27 19:30;24604;1272;583;0;0;26459
2022-04-27 20:30;24817;1482;586;0;0;26885
2022-04-27 21:30;23577;1736;589;0;0;25902
2022-04-27 22:30;22376;1884;589;0;0;24849
2022-04-27 23:30;20598;1966;588;0;0;23152
2022-04-28 00:30;19538;1916;586;0;0;22040
2022-04-28 01:30;19173;1885;586;0;0;21644
2022-04-28 02:30;19152;1887;589;0;0;21628
2022-04-28 03:30;18950;1540;585;0;0;21075
2022-04-28 04:30;19760;1907;584;0;0;22251
2022-04-28 05:30;21709;2108;585;0;0;24402
2022-04-28 06:30;24022;1720;589;0;0;26331
2022-04-28 07:30;25103;1720;588;1;0;27412
2022-04-28 08:30;24220;1780;586;4;0;26590
2022-04-28 09:30;23133;1889;587;7;0;25616
2022-04-28 10:30;21992;1913;579;9;0;24493
2022-04-28 11:30;21360;1976;588;9;0;23933
2022-04-28 12:30;20782;1979;618;9;0;23388
2022-04-28 13:30;20185;2052;616;9;0;22862
2022-04-28 14:30;19891;2058;616;9;0;22574
2022-04-28 15:30;19483;2145;616;9;0;22253
2022-04-28 16:30;19205;2283;616;8;0;22112
2022-04-28 17:30;20063;2664;614;5;0;23346
2022-04-28 18:30;20847;2313;617;1;0;23778
2022-04-28 19:30;21951;2245;621;0;0;24817
2022-04-28 20:30;22435;2260;622;0;0;25317
2022-04-28 21:30;21885;2228;624;0;0;24737
2022-04-28 22:30;20939;2242;623;0;0;23804
2022-04-28 23:30;19897;2250;622;0;0;22769
2022-04-29 00:30;18655;2240;621;0;0;21516
2022-04-29 01:30;18361;2258;621;0;0;21240
2022-04-29 02:30;18692;2214;621;0;0;21527
2022-04-29 03:30;18752;2156;622;0;0;21530
2022-04-29 04:30;19450;2098;623;0;0;22171
2022-04-29 05:30;21222;2016;624;0;0;23862
2022-04-29 06:30;23747;1872;626;0;0;26245
2022-04-29 07:30;24354;2098;625;1;0;27078
2022-04-29 08:30;23995;2027;627;5;0;26654
2022-04-29 09:30;23102;1877;625;7;0;25611
2022-04-29 10:30;22304;1417;624;9;0;24354
2022-04-29 11:30;21708;1512;622;9;0;23851
2022-04-29 12:30;21207;1583;621;8;0;23419
2022-04-29 13:30;20213;1636;593;9;0;22451
2022-04-29 14:30;19812;1647;595;9;0;22063
2022-04-29 15:30;19657;1645;596;8;0;21906
2022-04-29 16:30;19849;1939;597;3;0;22388
2022-04-29 17:30;20638;1832;597;3;0;23070
2022-04-29 18:30;21059;1614;613;1;0;23287
2022-04-29 19:30;21735;1412;614;0;0;23761
2022-04-29 20:30;22307;1457;619;0;0;24383
2022-04-29 21:30;21536;1324;624;0;0;23484
2022-04-29 22:30;20620;1222;625;0;0;22467
2022-04-29 23:30;20197;1082;624;0;0;21903
2022-04-30 00:30;19082;1114;623;0;0;20819
2022-04-30 01:30;18809;1140;623;0;0;20572
2022-04-30 02:30;19062;1096;624;0;0;20782
2022-04-30 03:30;19007;1037;622;0;0;20666
2022-04-30 04:30;19569;1072;623;0;0;21264
2022-04-30 05:30;19987;1102;621;0;0;21710
2022-04-30 06:30;20825;1032;617;0;0;22474
2022-04-30 07:30;21514;948;622;1;0;23085
2022-04-30 08:30;21602;859;624;5;0;23090
2022-04-30 09:30;21754;755;623;7;0;23139
2022-04-30 10:30;21676;698;627;9;0;23010
2022-04-30 11:30;21209;741;622;9;0;22581
2022-04-30 12:30;20733;814;631;9;0;22187
2022-04-30 13:30;19919;888;636;9;0;21452
2022-04-30 14:30;19409;959;633;9;0;21010
2022-04-30 15:30;18897;923;629;9;0;20458
2022-04-30 16:30;19032;867;628;7;0;20534
2022-04-30 17:30;19288;852;629;5;0;20774
2022-04-30 18:30;19211;939;629;1;0;20780
2022-04-30 19:30;19195;973;631;0;0;20799
2022-04-30 20:30;19664;1113;631;0;0;21408
2022-04-30 21:30;19051;1188;632;0;0;20871
2022-04-30 22:30;18462;1135;630;0;0;20227
2022-04-30 23:30;18023;1010;632;0;0;19665
2022-05-01 00:30;17426;893;632;0;0;18951
2022-05-01 01:30;17288;779;637;0;0;18704
2022-05-01 02:30;17714;648;631;0;0;18993
2022-05-01 03:30;17885;657;625;0;0;19167
2022-05-01 04:30;18280;626;627;0;0;19533
2022-05-01 05:30;18933;588;625;0;0;20146
2022-05-01 06:30;19440;466;627;0;0;20533
2022-05-01 07:30;19886;409;629;1;0;20925
2022-05-01 08:30;19970;487;629;5;0;21091
2022-05-01 09:30;20365;497;630;7;0;21499
2022-05-01 10:30;20123;550;630;9;0;21312
2022-05-01 11:30;19874;579;633;9;0;21095
2022-05-01 12:30;19795;676;618;9;0;21098
2022-05-01 13:30;18797;744;626;9;0;20176
2022-05-01 14:30;18292;825;622;9;0;19748
2022-05-01 15:30;18233;849;622;9;0;19713
2022-05-01 16:30;18444;787;626;7;0;19864
2022-05-01 17:30;19311;691;626;5;0;20633
2022-05-01 18:30;19736;587;627;1;0;20951
2022-05-01 19:30;20057;443;628;0;0;21128
2022-05-01 20:30;20165;551;628;0;0;21344
2022-05-01 21:30;19427;545;631;0;0;20603
2022-05-01 22:30;18024;662;632;0;0;19318
2022-05-01 23:30;16895;765;629;0;0;18289
2022-05-02 00:30;16070;885;628;0;0;17583
2022-05-02 01:30;15956;992;626;0;0;17574
2022-05-02 02:30;16003;964;627;0;0;17594
2022-05-02 03:30;16379;967;629;0;0;17975
2022-05-02 04:30;16746;1012;627;0;0;18385
2022-05-02 05:30;17655;1019;626;0;0;19300
2022-05-02 06:30;19539;951;626;0;0;21116
2022-05-02 07:30;21362;783;629;1;0;22775
2022-05-02 08:30;21762;678;628;5;0;23073
2022-05-02 09:30;22175;524;624;7;0;23330
2022-05-02 10:30;22034;510;628;6;0;23178
2022-05-02 11:30;22115;448;626;6;0;23195
2022-05-02 12:30;21341;387;623;4;0;22355
2022-05-02 13:30;21211;262;636;3;0;22112
2022-05-02 14:30;20788;240;637;2;0;21667
2022-05-02 15:30;20611;224;636;2;0;21473
2022-05-02 16:30;21386;228;637;2;0;22253
2022-05-02 17:30;22565;313;639;1;0;23518
2022-05-02 18:30;22639;414;638;0;0;23691
2022-05-02 19:30;22417;511;639;0;0;23567
2022-05-02 20:30;22132;650;636;0;0;23418
2022-05-02 21:30;20635;736;638;0;0;22009
2022-05-02 22:30;19031;801;639;0;0;20471
2022-05-02 23:30;17447;858;639;0;0;18944
2022-05-03 00:30;16405;1014;636;0;0;18055
2022-05-03 01:30;16289;1000;637;0;0;17926
2022-05-03 02:30;16174;940;636;0;0;17750
2022-05-03 03:30;16355;919;636;0;0;17910
2022-05-03 04:30;16751;784;636;0;0;18171
2022-05-03 05:30;18014;617;635;0;0;19266
2022-05-03 06:30;20762;490;636;0;0;21888
2022-05-03 07:30;22505;365;636;0;0;23506
2022-05-03 08:30;22645;155;636;2;0;23438
2022-05-03 09:30;22157;124;636;7;0;22924
2022-05-03 10:30;21745;113;632;6;0;22496
2022-05-03 11:30;21330;166;631;6;0;22133
2022-05-03 12:30;21221;215;636;6;0;22078
2022-05-03 13:30;20841;162;637;7;0;21647
2022-05-03 14:30;20355;155;631;5;0;21146
2022-05-03 15:30;20122;184;636;8;0;20950
2022-05-03 16:30;20580;252;637;3;0;21472
2022-05-03 17:30;21396;308;638;1;0;22343
2022-05-03 18:30;21661;438;642;1;0;22742
2022-05-03 19:30;21611;674;643;0;0;22928
2022-05-03 20:30;21496;885;646;0;0;23027
2022-05-03 21:30;19864;1176;644;0;0;21684
2022-05-03 22:30;18182;1250;643;0;0;20075
2022-05-03 23:30;16553;1383;643;0;0;18579
2022-05-04 00:30;16066;1582;643;0;0;18291
2022-05-04 01:30;15696;1744;639;0;0;18079
2022-05-04 02:30;15141;1952;641;0;0;17734
2022-05-04 03:30;15129;2048;642;0;0;17819
2022-05-04 04:30;15611;1917;641;0;0;18169
2022-05-04 05:30;16417;1751;643;0;0;18811
2022-05-04 06:30;18112;1553;643;0;0;20308
2022-05-04 07:30;19661;1489;643;0;0;21793
2022-05-04 08:30;20262;1290;643;0;0;22195
2022-05-04 09:30;20473;923;643;0;0;22039
2022-05-04 10:30;20534;826;639;1;0;22000
2022-05-04 11:30;20623;636;641;1;0;21901
2022-05-04 12:30;20357;510;643;1;0;21511
2022-05-04 13:30;20174;373;615;2;0;21164
2022-05-04 14:30;19743;348;615;6;0;20712
2022-05-04 15:30;19721;456;615;1;0;20793
2022-05-04 16:30;19722;692;617;3;0;21034
2022-05-04 17:30;20348;771;618;3;0;21740
2022-05-04 18:30;20259;978;618;1;0;21856
2022-05-04 19:30;20576;927;619;0;0;22122
2022-05-04 20:30;20985;1284;618;0;0;22887
2022-05-04 21:30;19727;1525;617;0;0;21869
2022-05-04 22:30;17852;1859;611;0;0;20322
2022-05-04 23:30;16300;2119;611;0;0;19030
2022-05-05 00:30;15845;2196;609;0;0;18650
2022-05-05 01:30;15725;2265;609;0;0;18599
2022-05-05 02:30;15973;2087;609;0;0;18669
2022-05-05 03:30;16154;2091;610;0;0;18855
2022-05-05 04:30;16624;2118;607;0;0;19349
2022-05-05 05:30;17459;2210;610;0;0;20279
2022-05-05 06:30;19469;2056;611;0;0;22136
2022-05-05 07:30;21069;1824;611;1;0;23505
2022-05-05 08:30;21146;1699;611;5;0;23461
2022-05-05 09:30;20327;1678;612;7;0;22624
2022-05-05 10:30;20153;1723;612;9;0;22497
2022-05-05 11:30;19692;1901;613;9;0;22215
2022-05-05 12:30;18814;2102;613;9;0;21538
2022-05-05 13:30;18229;2405;612;9;0;21255
2022-05-05 14:30;17700;2669;614;9;0;20992
2022-05-05 15:30;17267;2711;612;9;0;20599
2022-05-05 16:30;17774;2377;612;7;0;20770
2022-05-05 17:30;18302;2355;615;5;0;21277
2022-05-05 18:30;18773;2235;615;2;0;21625
2022-05-05 19:30;19084;2042;618;0;0;21744
2022-05-05 20:30;19865;2099;620;0;0;22584
2022-05-05 21:30;19472;2045;621;0;0;22138
2022-05-05 22:30;18094;1877;621;0;0;20592
2022-05-05 23:30;16835;1792;621;0;0;19248
2022-05-06 00:30;16308;1741;616;0;0;18665
2022-05-06 01:30;16570;1488;617;0;0;18675
2022-05-06 02:30;16634;1423;617;0;0;18674
2022-05-06 03:30;17103;1251;617;0;0;18971
2022-05-06 04:30;17825;1076;617;0;0;19518
2022-05-06 05:30;18849;931;616;0;0;20396
2022-05-06 06:30;20190;856;616;0;0;21662
2022-05-06 07:30;21457;886;618;1;0;22962
2022-05-06 08:30;21254;853;617;5;0;22729
2022-05-06 09:30;20464;1004;620;6;0;22094
2022-05-06 10:30;20167;1103;619;9;0;21898
2022-05-06 11:30;20079;1192;615;9;0;21895
2022-05-06 12:30;19749;1176;618;9;0;21552
2022-05-06 13:30;19458;1095;621;9;0;21183
2022-05-06 14:30;19093;1045;619;9;0;20766
2022-05-06 15:30;19136;971;619;9;0;20735
2022-05-06 16:30;19064;911;619;8;0;20602
2022-05-06 17:30;19647;811;621;5;0;21084
2022-05-06 18:30;19583;677;622;3;0;20885
2022-05-06 19:30;19772;476;623;0;0;20871
2022-05-06 20:30;20032;549;623;0;0;21204
2022-05-06 21:30;19276;813;625;0;0;20714
2022-05-06 22:30;18837;891;626;0;0;20354
2022-05-06 23:30;18407;914;626;0;0;19947
2022-05-07 00:30;17877;924;626;0;0;19427
2022-05-07 01:30;18073;786;626;0;0;19485
2022-05-07 02:30;18404;674;625;0;0;19703
2022-05-07 03:30;18373;718;625;0;0;19716
2022-05-07 04:30;18829;755;624;0;0;20208
2022-05-07 05:30;19254;898;625;0;0;20777
2022-05-07 06:30;19158;846;627;0;0;20631
2022-05-07 07:30;20133;802;627;1;0;21563
2022-05-07 08:30;20368;843;628;5;0;21844
2022-05-07 09:30;20740;881;627;7;0;22255
2022-05-07 10:30;20605;751;618;9;0;21983
2022-05-07 11:30;20858;609;616;9;0;22092
2022-05-07 12:30;20625;576;614;9;0;21824
2022-05-07 13:30;19970;494;652;9;0;21125
2022-05-07 14:30;19463;447;653;9;0;20572
2022-05-07 15:30;19141;509;652;9;0;20311
2022-05-07 16:30;19187;503;654;8;0;20352
2022-05-07 17:30;19670;516;651;5;0;20842
2022-05-07 18:30;19715;446;654;3;0;20818
2022-05-07 19:30;19629;354;661;0;0;20644
2022-05-07 20:30;19989;516;663;0;0;21168
2022-05-07 21:30;19819;675;664;0;0;21158
2022-05-07 22:30;19437;688;664;0;0;20789
2022-05-07 23:30;18459;723;668;0;0;19850
2022-05-08 00:30;17647;751;669;0;0;19067
2022-05-08 01:30;17160;703;670;0;0;18533
2022-05-08 02:30;17174;633;667;0;0;18474
2022-05-08 03:30;17538;570;668;0;0;18776
2022-05-08 04:30;18210;408;666;0;0;19284
2022-05-08 05:30;18404;325;666;0;0;19395
2022-05-08 06:30;18970;242;666;0;0;19878
2022-05-08 07:30;19744;93;667;1;0;20505
2022-05-08 08:30;19809;85;669;5;0;20568
2022-05-08 09:30;20009;95;668;7;0;20779
2022-05-08 10:30;20226;113;667;9;0;21015
2022-05-08 11:30;19954;131;664;9;0;20758
2022-05-08 12:30;19511;192;638;9;0;20350
2022-05-08 13:30;18741;224;639;9;0;19613
2022-05-08 14:30;18814;224;637;9;0;19684
2022-05-08 15:30;18849;211;638;9;0;19707
2022-05-08 16:30;18932;182;639;7;0;19760
2022-05-08 17:30;19455;188;637;5;0;20285
2022-05-08 18:30;19649;175;642;3;0;20469
2022-05-08 19:30;20116;199;641;0;0;20956
2022-05-08 20:30;20650;246;643;0;0;21539
2022-05-08 21:30;20424;311;643;0;0;21378
2022-05-08 22:30;18957;404;641;0;0;20002
2022-05-08 23:30;16775;346;590;0;0;17711
2022-05-09 00:30;16639;186;591;0;0;17416
2022-05-09 01:30;16537;170;591;0;0;17298
2022-05-09 02:30;16683;124;589;0;0;17396
2022-05-09 03:30;16876;118;589;0;0;17583
2022-05-09 04:30;17666;103;587;0;0;18356
2022-05-09 05:30;18890;78;587;0;0;19555
2022-05-09 06:30;20998;89;588;0;0;21675
2022-05-09 07:30;22168;55;590;1;0;22814
2022-05-09 08:30;21860;28;590;5;0;22483
2022-05-09 09:30;21094;59;588;7;0;21748
2022-05-09 10:30;21104;92;589;9;0;21794
2022-05-09 11:30;20628;85;588;9;0;21310
2022-05-09 12:30;20769;75;585;9;0;21438
2022-05-09 13:30;19963;82;575;9;0;20629
2022-05-09 14:30;19925;109;573;9;0;20616
2022-05-09 15:30;19328;130;574;9;0;20041
2022-05-09 16:30;19929;147;573;7;0;20656
2022-05-09 17:30;20379;142;563;5;0;21089
2022-05-09 18:30;21207;184;569;3;0;21963
2022-05-09 19:30;21627;339;572;0;0;22538
2022-05-09 20:30;21819;547;573;0;0;22939
2022-05-09 21:30;20686;649;575;0;0;21910
2022-05-09 22:30;18615;843;577;0;0;20035
2022-05-09 23:30;16063;1387;576;0;0;18026
2022-05-10 00:30;15772;1524;576;0;0;17872
2022-05-10 01:30;15407;1540;577;0;0;17524
2022-05-10 02:30;15620;1237;579;0;0;17436
2022-05-10 03:30;15984;1087;578;0;0;17649
2022-05-10 04:30;15886;1030;577;0;0;17493
2022-05-10 05:30;16529;925;578;0;0;18032
2022-05-10 06:30;18637;738;577;0;0;19952
2022-05-10 07:30;20472;349;578;1;0;21400
2022-05-10 08:30;20668;107;577;5;0;21357
2022-05-10 09:30;20089;72;579;7;0;20747
2022-05-10 10:30;20050;73;576;9;0;20708
2022-05-10 11:30;19958;110;578;9;0;20655
2022-05-10 12:30;20139;106;582;9;0;20836
2022-05-10 13:30;19964;197;586;9;0;20756
2022-05-10 14:30;19991;305;582;9;0;20887
2022-05-10 15:30;19880;296;581;9;0;20766
2022-05-10 16:30;20321;287;580;7;0;21195
2022-05-10 17:30;21172;342;582;5;0;22101
2022-05-10 18:30;21316;408;582;2;0;22308
2022-05-10 19:30;21323;575;581;0;0;22479
2022-05-10 20:30;20797;1146;582;0;0;22525
2022-05-10 21:30;19229;1733;582;0;0;21544
2022-05-10 22:30;17058;2142;582;0;0;19782
2022-05-10 23:30;15190;2180;580;0;0;17950
2022-05-11 00:30;14390;2198;581;0;0;17169
2022-05-11 01:30;13888;2301;582;0;0;16771
2022-05-11 02:30;13711;2301;581;0;0;16593
2022-05-11 03:30;14145;2163;582;0;0;16890
2022-05-11 04:30;14413;1982;582;0;0;16977
2022-05-11 05:30;16046;1803;582;0;0;18431
2022-05-11 06:30;18092;1597;582;0;0;20271
2022-05-11 07:30;19978;1214;583;1;0;21776
2022-05-11 08:30;21151;723;583;5;0;22462
2022-05-11 09:30;20666;518;586;7;0;21777
2022-05-11 10:30;20889;447;583;9;0;21928
2022-05-11 11:30;20815;477;580;9;0;21881
2022-05-11 12:30;20941;613;581;9;0;22144
2022-05-11 13:30;20477;775;581;9;0;21842
2022-05-11 14:30;20671;849;575;9;0;22104
2022-05-11 15:30;20679;873;578;8;0;22138
2022-05-11 16:30;21307;652;580;7;0;22546
2022-05-11 17:30;22233;457;581;5;0;23276
2022-05-11 18:30;22139;545;583;2;0;23269
2022-05-11 19:30;21848;613;585;1;0;23047
2022-05-11 20:30;21853;689;584;0;0;23126
2022-05-11 21:30;21122;772;583;0;0;22477
2022-05-11 22:30;19223;1278;584;0;0;21085
2022-05-11 23:30;17963;1172;584;0;0;19719
2022-05-12 00:30;16585;1342;585;0;0;18512
2022-05-12 01:30;16082;1444;584;0;0;18110
2022-05-12 02:30;15947;1485;583;0;0;18015
2022-05-12 03:30;15720;1308;583;0;0;17611
2022-05-12 04:30;16068;1210;581;0;0;17859
2022-05-12 05:30;16825;1181;581;0;0;18587
2022-05-12 06:30;18420;1128;583;0;0;20131
2022-05-12 07:30;19892;899;582;1;0;21374
2022-05-12 08:30;20800;831;584;4;0;22219
2022-05-12 09:30;20676;741;583;6;0;22006
2022-05-12 10:30;21213;615;585;8;0;22421
2022-05-12 11:30;21357;635;585;9;0;22586
2022-05-12 12:30;21409;650;572;9;0;22640
2022-05-12 13:30;21788;697;571;9;0;23065
2022-05-12 14:30;21565;625;571;9;0;22770
2022-05-12 15:30;21472;570;572;8;0;22622
2022-05-12 16:30;22529;445;572;7;0;23553
2022-05-12 17:30;22613;304;572;3;0;23492
2022-05-12 18:30;22716;159;571;2;0;23448
2022-05-12 19:30;22593;127;572;0;0;23292
2022-05-12 20:30;22359;446;571;0;0;23376
2022-05-12 21:30;21849;723;570;0;0;23142
2022-05-12 22:30;20228;1012;570;0;0;21810
2022-05-12 23:30;18286;1014;569;0;0;19869
2022-05-13 00:30;17198;1063;569;0;0;18830
2022-05-13 01:30;15994;1055;568;0;0;17617
2022-05-13 02:30;15449;1277;566;0;0;17292
2022-05-13 03:30;15287;1226;567;0;0;17080
2022-05-13 04:30;15313;1375;568;0;0;17256
2022-05-13 05:30;15686;1605;568;0;0;17859
2022-05-13 06:30;17457;1796;569;0;0;19822
2022-05-13 07:30;19233;1844;567;1;0;21645
2022-05-13 08:30;20001;1796;570;4;0;22371
2022-05-13 09:30;20297;1647;572;6;0;22522
2022-05-13 10:30;21043;1544;569;8;0;23164
2022-05-13 11:30;21329;1398;566;9;0;23302
2022-05-13 12:30;21469;1258;556;9;0;23292
2022-05-13 13:30;21960;1120;558;9;0;23647
2022-05-13 14:30;21697;1128;556;9;0;23390
2022-05-13 15:30;22657;1111;556;8;0;24332
2022-05-13 16:30;23250;1127;553;7;0;24937
2022-05-13 17:30;23530;1165;555;5;0;25255
2022-05-13 18:30;23291;1158;549;2;0;25000
2022-05-13 19:30;22943;1042;555;0;0;24540
2022-05-13 20:30;22317;1294;557;0;0;24168
2022-05-13 21:30;21974;1418;557;0;0;23949
2022-05-13 22:30;20852;1623;558;0;0;23033
2022-05-13 23:30;19297;1596;560;0;0;21453
2022-05-14 00:30;17983;1599;561;0;0;20143
2022-05-14 01:30;16805;1494;560;0;0;18859
2022-05-14 02:30;15997;1346;561;0;0;17904
2022-05-14 03:30;15632;1275;561;0;0;17468
2022-05-14 04:30;15779;1279;560;0;0;17618
2022-05-14 05:30;15915;1200;560;0;0;17675
2022-05-14 06:30;17013;950;560;0;0;18523
2022-05-14 07:30;18466;741;559;1;0;19767
2022-05-14 08:30;20398;535;563;5;0;21501
2022-05-14 09:30;21744;389;563;7;0;22703
2022-05-14 10:30;22749;352;564;8;0;23673
2022-05-14 11:30;23272;299;563;9;0;24143
2022-05-14 12:30;23510;325;586;9;0;24430
2022-05-14 13:30;23459;343;585;9;0;24396
2022-05-14 14:30;23170;300;586;9;0;24065
2022-05-14 15:30;22966;222;587;8;0;23783
2022-05-14 16:30;23094;186;586;7;0;23873
2022-05-14 17:30;23550;177;588;3;0;24318
2022-05-14 18:30;23212;244;588;1;0;24045
2022-05-14 19:30;22354;347;588;0;0;23289
2022-05-14 20:30;22411;594;585;0;0;23590
2022-05-14 21:30;22264;737;587;0;0;23588
2022-05-14 22:30;20837;1036;589;0;0;22462
2022-05-14 23:30;19480;1087;591;0;0;21158
2022-05-15 00:30;18385;1208;591;0;0;20184
2022-05-15 01:30;17363;1204;590;0;0;19157
2022-05-15 02:30;16806;1141;589;0;0;18536
2022-05-15 03:30;16005;1224;588;0;0;17817
2022-05-15 04:30;15989;1306;587;0;0;17882
2022-05-15 05:30;15803;1218;588;0;0;17609
2022-05-15 06:30;16550;1116;588;0;0;18254
2022-05-15 07:30;18367;954;586;1;0;19908
2022-05-15 08:30;19471;847;585;1;0;20904
2022-05-15 09:30;20510;834;580;1;0;21925
2022-05-15 10:30;21784;784;579;3;0;23150
2022-05-15 11:30;21833;859;582;7;0;23281
2022-05-15 12:30;21975;883;605;5;0;23468
2022-05-15 13:30;22251;949;607;3;0;23810
2022-05-15 14:30;21000;1080;607;6;0;22693
2022-05-15 15:30;21196;1226;607;6;0;23035
2022-05-15 16:30;21444;1387;607;3;0;23441
2022-05-15 17:30;22172;1553;610;2;0;24337
2022-05-15 18:30;22340;1680;609;1;0;24630
2022-05-15 19:30;22048;1726;609;1;0;24384
2022-05-15 20:30;21727;1893;609;0;0;24229
2022-05-15 21:30;21164;1849;610;0;0;23623
2022-05-15 22:30;20091;1836;610;0;0;22537
2022-05-15 23:30;19084;1691;610;0;0;21385
2022-05-16 00:30;18567;1508;604;0;0;20679
2022-05-16 01:30;17787;1373;607;0;0;19767
2022-05-16 02:30;17111;1498;610;0;0;19219
2022-05-16 03:30;16805;1599;610;0;0;19014
2022-05-16 04:30;17002;1469;609;0;0;19080
2022-05-16 05:30;18483;1386;606;0;0;20475
2022-05-16 06:30;20275;1183;610;0;0;22068
2022-05-16 07:30;22265;907;608;1;0;23781
2022-05-16 08:30;23248;553;611;3;0;24415
2022-05-16 09:30;23519;421;607;4;0;24551
2022-05-16 10:30;23588;237;607;6;0;24438
2022-05-16 11:30;23912;90;606;6;0;24614
2022-05-16 12:30;24018;21;611;9;0;24659
2022-05-16 13:30;23841;34;613;6;0;24494
2022-05-16 14:30;23267;99;611;1;0;23978
2022-05-16 15:30;23240;163;611;3;0;24017
2022-05-16 16:30;23307;216;610;0;0;24133
2022-05-16 17:30;23926;361;611;0;0;24898
2022-05-16 18:30;23980;607;612;0;0;25199
2022-05-16 19:30;22898;852;611;0;0;24361
2022-05-16 20:30;22160;1109;612;0;0;23881
2022-05-16 21:30;21014;1424;613;0;0;23051
2022-05-16 22:30;19687;1585;612;0;0;21884
2022-05-16 23:30;17866;1789;613;0;0;20268
2022-05-17 00:30;16521;1905;613;0;0;19039
2022-05-17 01:30;15383;2056;614;0;0;18053
2022-05-17 02:30;14813;2154;614;0;0;17581
2022-05-17 03:30;14392;2251;614;0;0;17257
2022-05-17 04:30;14268;2492;613;0;0;17373
2022-05-17 05:30;15137;2501;612;0;0;18250
2022-05-17 06:30;17175;2599;613;0;0;20387
2022-05-17 07:30;19415;2573;613;1;0;22602
2022-05-17 08:30;20040;2503;613;1;0;23157
2022-05-17 09:30;19878;2503;616;1;0;22998
2022-05-17 10:30;19839;2187;604;3;0;22633
2022-05-17 11:30;20745;1851;602;3;0;23201
2022-05-17 12:30;20449;1834;609;6;0;22898
2022-05-17 13:30;20292;1827;611;4;0;22734
2022-05-17 14:30;19843;1980;610;4;0;22437
2022-05-17 15:30;20025;2066;611;4;0;22706
2022-05-17 16:30;20616;2063;608;3;0;23290
2022-05-17 17:30;21997;1987;610;3;0;24597
2022-05-17 18:30;21416;2127;612;1;0;24156
2022-05-17 19:30;21790;2434;614;0;0;24838
2022-05-17 20:30;21418;2590;615;0;0;24623
2022-05-17 21:30;20743;2567;618;0;0;23928
2022-05-17 22:30;19849;2397;618;0;0;22864
2022-05-17 23:30;18037;2447;615;0;0;21099
2022-05-18 00:30;17557;2435;616;0;0;20608
2022-05-18 01:30;16540;2303;615;0;0;19458
2022-05-18 02:30;16513;2212;614;0;0;19339
2022-05-18 03:30;16364;2201;613;0;0;19178
2022-05-18 04:30;16910;2225;613;0;0;19748
2022-05-18 05:30;18218;2328;613;0;0;21159
2022-05-18 06:30;20375;2392;613;0;0;23380
2022-05-18 07:30;21789;2047;611;3;0;24450
2022-05-18 08:30;21665;2076;611;5;0;24357
2022-05-18 09:30;21173;2080;614;7;0;23874
2022-05-18 10:30;21049;2144;613;9;0;23815
2022-05-18 11:30;21145;2250;611;9;0;24015
2022-05-18 12:30;20927;2144;609;9;0;23689
2022-05-18 13:30;20682;2204;609;9;0;23504
2022-05-18 14:30;20383;1997;609;9;0;22998
2022-05-18 15:30;19964;1925;607;9;0;22505
2022-05-18 16:30;20618;1775;605;7;0;23005
2022-05-18 17:30;21359;1679;608;5;0;23651
2022-05-18 18:30;21538;1417;608;3;0;23566
2022-05-18 19:30;21629;1254;608;0;0;23491
2022-05-18 20:30;22085;1530;609;0;0;24224
2022-05-18 21:30;21747;1066;610;0;0;23423
2022-05-18 22:30;20107;1557;608;0;0;22272
2022-05-18 23:30;19096;1369;609;0;0;21074
2022-05-19 00:30;18919;1177;609;0;0;20705
2022-05-19 01:30;19189;940;609;0;0;20738
2022-05-19 02:30;18233;979;610;0;0;19822
2022-05-19 03:30;18142;1116;608;0;0;19866
2022-05-19 04:30;18255;1193;608;0;0;20056
2022-05-19 05:30;19358;1244;608;0;0;21210
2022-05-19 06:30;21254;1251;607;0;0;23112
2022-05-19 07:30;22875;996;606;2;0;24479
2022-05-19 08:30;23086;823;607;1;0;24517
2022-05-19 09:30;22724;831;608;2;0;24165
2022-05-19 10:30;22472;947;606;2;0;24027
2022-05-19 11:30;22757;917;603;1;0;24278
2022-05-19 12:30;22658;891;603;1;0;24153
2022-05-19 13:30;22751;891;602;1;0;24245
2022-05-19 14:30;22465;905;603;1;0;23974
2022-05-19 15:30;22342;866;603;1;0;23812
2022-05-19 16:30;22874;793;601;1;0;24269
2022-05-19 17:30;23953;689;603;1;0;25246
2022-05-19 18:30;23940;510;607;0;0;25057
2022-05-19 19:30;23733;461;606;0;0;24800
2022-05-19 20:30;23247;720;607;0;0;24574
2022-05-19 21:30;22323;1014;609;0;0;23946
2022-05-19 22:30;21519;971;607;0;0;23097
2022-05-19 23:30;19595;966;608;0;0;21169
2022-05-20 00:30;18413;987;611;0;0;20011
2022-05-20 01:30;17566;1007;610;0;0;19183
2022-05-20 02:30;17096;896;611;0;0;18603
2022-05-20 03:30;16464;794;611;0;0;17869
2022-05-20 04:30;16847;742;611;0;0;18200
2022-05-20 05:30;17552;479;608;0;0;18639
2022-05-20 06:30;20026;324;608;1;0;20959
2022-05-20 07:30;22154;199;609;2;0;22964
2022-05-20 08:30;23393;186;608;3;0;24190
2022-05-20 09:30;22620;306;603;4;0;23533
2022-05-20 10:30;22371;451;604;9;0;23435
2022-05-20 11:30;21733;754;607;8;0;23102
2022-05-20 12:30;20648;971;617;9;0;22245
2022-05-20 13:30;20252;956;617;9;0;21834
2022-05-20 14:30;20622;1074;618;9;0;22323
2022-05-20 15:30;20413;1109;616;9;0;22147
2022-05-20 16:30;20874;1404;614;7;0;22899
2022-05-20 17:30;20956;1779;615;5;0;23355
2022-05-20 18:30;20760;2024;615;2;0;23401
2022-05-20 19:30;20198;2303;615;1;0;23117
2022-05-20 20:30;19664;2664;615;0;0;22943
2022-05-20 21:30;19103;2403;619;0;0;22125
2022-05-20 22:30;18237;2301;618;0;0;21156
2022-05-20 23:30;17371;2288;621;0;0;20280
2022-05-21 00:30;15591;2308;620;0;0;18519
2022-05-21 01:30;14917;2306;619;0;0;17842
2022-05-21 02:30;14376;2279;617;0;0;17272
2022-05-21 03:30;13586;2191;616;0;0;16393
2022-05-21 04:30;13698;2163;616;0;0;16477
2022-05-21 05:30;14236;2303;618;0;0;17157
2022-05-21 06:30;14971;2335;617;0;0;17923
2022-05-21 07:30;16814;1962;616;1;0;19393
2022-05-21 08:30;18292;1970;617;4;0;20883
2022-05-21 09:30;19901;2305;612;6;0;22824
2022-05-21 10:30;20739;2317;611;8;0;23675
2022-05-21 11:30;20989;2342;606;9;0;23946
2022-05-21 12:30;20897;2164;631;9;0;23701
2022-05-21 13:30;21293;1923;631;7;0;23854
2022-05-21 14:30;21614;1904;633;5;0;24156
2022-05-21 15:30;21644;1852;631;4;0;24131
2022-05-21 16:30;20210;1716;632;5;0;22563
2022-05-21 17:30;19709;1569;629;1;0;21908
2022-05-21 18:30;19792;1232;631;1;0;21656
2022-05-21 19:30;19100;1095;631;0;0;20826
2022-05-21 20:30;19605;850;634;0;0;21089
2022-05-21 21:30;19751;763;638;0;0;21152
2022-05-21 22:30;19091;722;640;0;0;20453
2022-05-21 23:30;18576;611;639;0;0;19826
2022-05-22 00:30;18066;500;640;0;0;19206
2022-05-22 01:30;17982;513;637;0;0;19132
2022-05-22 02:30;16760;527;633;0;0;17920
2022-05-22 03:30;16432;538;635;0;0;17605
2022-05-22 04:30;16479;328;635;0;0;17442
2022-05-22 05:30;16394;275;637;0;0;17306
2022-05-22 06:30;16365;165;634;0;0;17164
2022-05-22 07:30;17211;234;632;0;0;18077
2022-05-22 08:30;18591;300;633;0;0;19524
2022-05-22 09:30;19240;284;629;0;0;20153
2022-05-22 10:30;19520;424;630;8;0;20582
2022-05-22 11:30;19804;552;632;8;0;20996
2022-05-22 12:30;20120;691;596;9;0;21416
2022-05-22 13:30;19877;1157;592;7;0;21633
2022-05-22 14:30;19484;1394;602;3;0;21483
2022-05-22 15:30;18473;1730;598;2;0;20803
2022-05-22 16:30;18758;1754;602;1;0;21115
2022-05-22 17:30;19912;1772;604;1;0;22289
2022-05-22 18:30;19087;1799;605;1;0;21492
2022-05-22 19:30;19154;1506;604;0;0;21264
2022-05-22 20:30;18605;2106;605;0;0;21316
2022-05-22 21:30;17437;2261;608;0;0;20306
2022-05-22 22:30;16126;2062;609;0;0;18797
2022-05-22 23:30;15825;1836;609;0;0;18270
2022-05-23 00:30;15017;2343;603;0;0;17963
2022-05-23 01:30;14398;2457;605;0;0;17460
2022-05-23 02:30;14538;2327;602;0;0;17467
2022-05-23 03:30;14906;2358;600;0;0;17864
2022-05-23 04:30;15339;2133;601;0;0;18073
2022-05-23 05:30;15538;1971;600;0;0;18109
2022-05-23 06:30;16108;1952;599;0;0;18659
2022-05-23 07:30;17465;1741;597;3;0;19806
2022-05-23 08:30;18112;1583;595;5;0;20295
2022-05-23 09:30;18765;1494;595;7;0;20861
2022-05-23 10:30;19597;1449;592;9;0;21647
2022-05-23 11:30;19479;1375;594;9;0;21457
2022-05-23 12:30;19830;1325;597;9;0;21761
2022-05-23 13:30;19548;1336;595;9;0;21488
2022-05-23 14:30;19103;1348;596;9;0;21056
2022-05-23 15:30;19218;1295;596;4;0;21113
2022-05-23 16:30;19712;1264;594;7;0;21577
2022-05-23 17:30;20912;1238;598;2;0;22750
2022-05-23 18:30;21314;1087;597;1;0;22999
2022-05-23 19:30;21811;830;600;1;0;23242
2022-05-23 20:30;21808;795;601;0;0;23204
2022-05-23 21:30;21187;854;604;0;0;22645
2022-05-23 22:30;20069;697;604;0;0;21370
2022-05-23 23:30;18841;611;602;0;0;20054
2022-05-24 00:30;17917;546;602;0;0;19065
2022-05-24 01:30;17506;516;612;0;0;18634
2022-05-24 02:30;17480;493;613;0;0;18586
2022-05-24 03:30;16925;446;610;0;0;17981
2022-05-24 04:30;17444;449;609;0;0;18502
2022-05-24 05:30;18903;347;609;0;0;19859
2022-05-24 06:30;20696;190;609;0;0;21495
2022-05-24 07:30;22748;80;607;3;0;23438
2022-05-24 08:30;23233;116;606;5;0;23960
2022-05-24 09:30;23066;128;598;7;0;23799
2022-05-24 10:30;22900;102;604;9;0;23615
2022-05-24 11:30;23094;84;605;8;0;23791
2022-05-24 12:30;22886;84;610;9;0;23589
2022-05-24 13:30;22832;81;613;8;0;23534
2022-05-24 14:30;22366;91;610;5;0;23072
2022-05-24 15:30;22289;66;606;9;0;22970
2022-05-24 16:30;23041;83;611;6;0;23741
2022-05-24 17:30;23772;110;608;4;0;24494
2022-05-24 18:30;23725;115;609;3;0;24452
2022-05-24 19:30;23471;172;608;0;0;24251
2022-05-24 20:30;22861;293;610;0;0;23764
2022-05-24 21:30;22349;503;613;0;0;23465
2022-05-24 22:30;21249;651;612;0;0;22512
2022-05-24 23:30;19344;802;611;0;0;20757
2022-05-25 00:30;18084;873;611;0;0;19568
2022-05-25 01:30;16859;1041;609;0;0;18509
2022-05-25 02:30;15991;1090;609;0;0;17690
2022-05-25 03:30;16125;1119;608;0;0;17852
2022-05-25 04:30;16353;1081;608;0;0;18042
2022-05-25 05:30;17216;976;607;0;0;18799
2022-05-25 06:30;19557;807;607;0;0;20971
2022-05-25 07:30;21145;497;603;3;0;22248
2022-05-25 08:30;21829;392;604;5;27;22857
2022-05-25 09:30;21309;558;600;7;0;22474
2022-05-25 10:30;20903;739;599;8;0;22249
2022-05-25 11:30;20808;952;601;9;0;22370
2022-05-25 12:30;20879;968;609;9;0;22465
2022-05-25 13:30;20709;1094;611;9;0;22423
2022-05-25 14:30;20111;1127;614;9;0;21861
2022-05-25 15:30;19901;1305;616;9;0;21831
2022-05-25 16:30;20430;1104;622;7;0;22163
2022-05-25 17:30;20894;1154;622;4;0;22674
2022-05-25 18:30;21433;827;619;1;0;22880
2022-05-25 19:30;21470;626;621;1;0;22718
2022-05-25 20:30;21743;779;622;0;0;23144
2022-05-25 21:30;20688;891;627;0;0;22206
2022-05-25 22:30;19014;803;624;0;0;20441
2022-05-25 23:30;17233;809;626;0;0;18668
2022-05-26 00:30;15956;655;625;0;0;17236
2022-05-26 01:30;15792;472;641;0;0;16905
2022-05-26 02:30;15779;313;641;0;0;16733
2022-05-26 03:30;15803;239;634;0;0;16676
2022-05-26 04:30;15876;210;630;0;0;16716
2022-05-26 05:30;16420;229;633;0;0;17282
2022-05-26 06:30;18223;301;634;0;0;19158
2022-05-26 07:30;19787;318;635;0;0;20740
2022-05-26 08:30;20568;330;635;1;0;21534
2022-05-26 09:30;20648;267;626;1;0;21542
2022-05-26 10:30;20744;321;626;2;0;21693
2022-05-26 11:30;20653;510;632;6;0;21801
2022-05-26 12:30;20505;596;633;8;0;21742
2022-05-26 13:30;20319;852;633;9;0;21813
2022-05-26 14:30;19994;1078;627;4;0;21703
2022-05-26 15:30;20384;1270;632;3;0;22289
2022-05-26 16:30;20740;1380;637;1;0;22758
2022-05-26 17:30;21352;1437;638;1;0;23428
2022-05-26 18:30;20775;1925;637;1;0;23338
2022-05-26 19:30;20910;2094;641;0;0;23645
2022-05-26 20:30;20951;2240;638;0;0;23829
2022-05-26 21:30;19611;2246;639;0;0;22496
2022-05-26 22:30;17819;2402;645;0;0;20866
2022-05-26 23:30;16092;2313;646;0;0;19051
2022-05-27 00:30;14866;2197;643;0;0;17706
2022-05-27 01:30;14592;2331;642;0;0;17565
2022-05-27 02:30;14633;2049;641;0;0;17323
2022-05-27 03:30;14789;1785;640;0;0;17214
2022-05-27 04:30;15050;1726;640;0;0;17416
2022-05-27 05:30;16190;1543;639;0;0;18372
2022-05-27 06:30;18479;1433;640;0;0;20552
2022-05-27 07:30;20111;1373;638;0;0;22122
2022-05-27 08:30;20659;1220;633;1;0;22513
2022-05-27 09:30;21937;1070;636;1;0;23644
2022-05-27 10:30;23298;846;638;0;0;24782
2022-05-27 11:30;23010;789;636;2;0;24437
2022-05-27 12:30;23207;795;637;2;0;24641
2022-05-27 13:30;23119;859;628;2;0;24608
2022-05-27 14:30;23037;784;636;1;0;24458
2022-05-27 15:30;22585;976;635;1;0;24197
2022-05-27 16:30;22393;1033;633;1;0;24060
2022-05-27 17:30;23192;1158;632;2;0;24984
2022-05-27 18:30;22684;1372;630;1;0;24687
2022-05-27 19:30;22259;1584;631;0;0;24474
2022-05-27 20:30;21724;1169;635;0;0;23528
2022-05-27 21:30;21522;1188;639;0;0;23349
2022-05-27 22:30;20206;1141;640;0;0;21987
2022-05-27 23:30;18514;1189;641;0;0;20344
2022-05-28 00:30;17496;1542;643;0;0;19681
2022-05-28 01:30;16425;1541;643;0;0;18609
2022-05-28 02:30;16062;1471;641;0;0;18174
2022-05-28 03:30;15773;1456;641;0;0;17870
2022-05-28 04:30;15701;1371;640;0;0;17712
2022-05-28 05:30;15524;1368;641;0;0;17533
2022-05-28 06:30;16437;1128;640;0;0;18205
2022-05-28 07:30;17832;1032;636;0;0;19500
2022-05-28 08:30;19112;789;633;2;0;20536
2022-05-28 09:30;20606;500;631;1;0;21738
2022-05-28 10:30;21127;442;628;1;0;22198
2022-05-28 11:30;21434;454;631;7;0;22526
2022-05-28 12:30;20656;581;630;2;0;21869
2022-05-28 13:30;20984;725;634;4;0;22347
2022-05-28 14:30;19748;1018;633;6;0;21405
2022-05-28 15:30;19017;1220;628;5;0;20870
2022-05-28 16:30;19588;1401;629;6;0;21624
2022-05-28 17:30;19694;1407;632;6;0;21739
2022-05-28 18:30;20409;1133;627;2;0;22171
2022-05-28 19:30;20494;1072;601;0;0;22167
2022-05-28 20:30;20285;1354;610;0;0;22249
2022-05-28 21:30;19545;1566;612;0;0;21723
2022-05-28 22:30;17933;1801;612;0;0;20346
2022-05-28 23:30;16833;2076;615;0;0;19524
2022-05-29 00:30;15167;1865;613;0;0;17645
2022-05-29 01:30;14685;1810;611;0;0;17106
2022-05-29 02:30;14214;2134;613;0;0;16961
2022-05-29 03:30;14633;1949;610;0;0;17192
2022-05-29 04:30;14831;2040;611;0;0;17482
2022-05-29 05:30;14228;2242;610;0;0;17080
2022-05-29 06:30;14561;2020;611;0;0;17192
2022-05-29 07:30;16152;1658;610;3;0;18423
2022-05-29 08:30;16984;1846;607;5;0;19442
2022-05-29 09:30;17406;2193;603;7;0;20209
2022-05-29 10:30;17775;2277;601;8;0;20661
2022-05-29 11:30;17650;2089;594;8;0;20341
2022-05-29 12:30;17881;2010;599;9;0;20499
2022-05-29 13:30;17444;1969;603;8;0;20024
2022-05-29 14:30;17616;2189;603;8;0;20416
2022-05-29 15:30;17500;1775;603;9;0;19887
2022-05-29 16:30;18765;1608;605;6;0;20984
2022-05-29 17:30;19864;1338;605;4;0;21811
2022-05-29 18:30;21221;1456;606;3;0;23286
2022-05-29 19:30;21995;1206;605;0;0;23806
2022-05-29 20:30;21077;1080;608;0;0;22765
2022-05-29 21:30;20575;1171;612;0;0;22358
2022-05-29 22:30;18895;1238;613;0;0;20746
2022-05-29 23:30;17268;1150;612;0;0;19030
2022-05-30 00:30;15937;1078;610;0;0;17625
2022-05-30 01:30;15884;962;611;0;0;17457
2022-05-30 02:30;15904;863;609;0;0;17376
2022-05-30 03:30;15783;861;609;0;0;17253
2022-05-30 04:30;15362;910;608;0;0;16880
2022-05-30 05:30;16149;936;608;0;0;17693
2022-05-30 06:30;17840;792;609;0;0;19241
2022-05-30 07:30;19867;711;606;0;0;21184
2022-05-30 08:30;20365;953;604;1;0;21923
2022-05-30 09:30;20613;1092;599;1;0;22305
2022-05-30 10:30;20421;1079;597;2;0;22099
2022-05-30 11:30;20863;1348;599;5;0;22815
2022-05-30 12:30;21587;1287;601;8;0;23483
2022-05-30 13:30;21709;1359;603;8;0;23679
2022-05-30 14:30;21545;1932;601;8;0;24086
2022-05-30 15:30;21938;1403;598;8;0;23947
2022-05-30 16:30;23324;1161;596;5;0;25086
2022-05-30 17:30;24126;881;599;3;0;25609
2022-05-30 18:30;24096;851;601;1;0;25549
2022-05-30 19:30;23826;822;603;0;0;25251
2022-05-30 20:30;23458;906;606;0;0;24970
2022-05-30 21:30;23379;1011;610;0;0;25000
2022-05-30 22:30;21658;1144;609;0;0;23411
2022-05-30 23:30;19510;1245;611;0;0;21366
2022-05-31 00:30;18009;1312;611;0;0;19932
2022-05-31 01:30;16714;1265;608;0;0;18587
2022-05-31 02:30;15590;1155;607;0;0;17352
2022-05-31 03:30;15849;1094;606;0;0;17549
2022-05-31 04:30;16081;1008;606;0;0;17695
2022-05-31 05:30;16298;1089;608;0;0;17995
2022-05-31 06:30;18974;1005;608;1;0;20588
2022-05-31 07:30;20703;1097;607;1;0;22408
2022-05-31 08:30;21975;1122;610;1;0;23708
2022-05-31 09:30;22027;1060;609;1;0;23697
2022-05-31 10:30;22277;1117;607;3;0;24004
2022-05-31 11:30;22225;1206;602;3;0;24036
2022-05-31 12:30;22363;1221;608;4;0;24196
2022-05-31 13:30;21998;1293;610;7;0;23908
2022-05-31 14:30;21408;1390;609;5;0;23412
2022-05-31 15:30;21448;1333;612;7;0;23400
2022-05-31 16:30;22208;1296;612;5;0;24121
2022-05-31 17:30;22714;914;607;4;0;24239
2022-05-31 18:30;23034;1146;611;3;0;24794
2022-05-31 19:30;22891;939;611;1;0;24442
2022-05-31 20:30;22781;827;612;0;0;24220
2022-05-31 21:30;22307;969;612;0;0;23888
2022-05-31 22:30;21124;1120;619;0;0;22863
2022-05-31 23:30;19740;1332;621;0;0;21693
2022-06-01 00:30;18494;1485;612;0;0;20591
2022-06-01 01:30;17566;1361;610;0;0;19537
2022-06-01 02:30;16687;1313;612;0;0;18612
2022-06-01 03:30;15827;1276;608;0;0;17711
2022-06-01 04:30;15624;1428;609;0;0;17661
2022-06-01 05:30;16648;1141;606;0;0;18395
2022-06-01 06:30;19236;808;607;0;0;20651
2022-06-01 07:30;21247;695;605;2;0;22549
2022-06-01 08:30;22686;633;606;0;0;23925
2022-06-01 09:30;22694;609;604;1;0;23908
2022-06-01 10:30;22764;666;597;1;0;24028
2022-06-01 11:30;22128;639;593;3;0;23363
2022-06-01 12:30;21333;674;633;3;0;22643
2022-06-01 13:30;22074;673;629;1;0;23377
2022-06-01 14:30;21861;742;629;2;0;23234
2022-06-01 15:30;21813;815;635;1;0;23264
2022-06-01 16:30;22392;663;634;2;0;23691
2022-06-01 17:30;23191;587;634;0;0;24412
2022-06-01 18:30;23410;452;637;0;0;24499
2022-06-01 19:30;23397;352;637;0;0;24386
2022-06-01 20:30;22991;400;637;0;0;24028
2022-06-01 21:30;22165;393;641;0;0;23199
2022-06-01 22:30;20420;479;647;0;0;21546
2022-06-01 23:30;18590;624;654;0;0;19868
2022-06-02 00:30;17366;606;652;0;0;18624
2022-06-02 01:30;16761;793;651;0;0;18205
2022-06-02 02:30;15843;854;649;0;0;17346
2022-06-02 03:30;15960;758;648;0;0;17366
2022-06-02 04:30;16316;510;648;0;0;17474
2022-06-02 05:30;16913;513;648;0;0;18074
2022-06-02 06:30;19071;339;649;0;0;20059
2022-06-02 07:30;21006;237;650;1;0;21894
2022-06-02 08:30;21705;244;650;4;0;22603
2022-06-02 09:30;21226;353;647;6;0;22232
2022-06-02 10:30;21533;341;647;9;0;22530
2022-06-02 11:30;21682;333;644;5;0;22664
2022-06-02 12:30;21388;313;618;5;0;22324
2022-06-02 13:30;21484;270;617;4;0;22375
2022-06-02 14:30;21437;248;614;9;0;22308
2022-06-02 15:30;21586;224;623;5;0;22438
2022-06-02 16:30;21884;234;623;6;0;22747
2022-06-02 17:30;22419;161;625;4;0;23209
2022-06-02 18:30;22616;150;626;1;0;23393
2022-06-02 19:30;22417;154;629;0;0;23200
2022-06-02 20:30;22311;233;625;0;0;23169
2022-06-02 21:30;21720;381;628;0;0;22729
2022-06-02 22:30;20557;462;628;0;0;21647
2022-06-02 23:30;18355;667;628;0;0;19650
2022-06-03 00:30;17136;775;626;0;0;18537
2022-06-03 01:30;16460;848;625;0;0;17933
2022-06-03 02:30;15857;898;625;0;0;17380
2022-06-03 03:30;16114;850;629;0;0;17593
2022-06-03 04:30;16118;888;625;0;0;17631
2022-06-03 05:30;16513;901;625;0;0;18039
2022-06-03 06:30;18531;870;624;0;0;20025
2022-06-03 07:30;20810;889;621;1;0;22321
2022-06-03 08:30;21800;756;622;5;0;23183
2022-06-03 09:30;22112;580;620;7;0;23319
2022-06-03 10:30;22241;684;618;9;0;23552
2022-06-03 11:30;21864;801;620;9;0;23294
2022-06-03 12:30;22558;775;620;9;0;23962
2022-06-03 13:30;21735;743;623;9;0;23110
2022-06-03 14:30;20940;660;621;8;0;22229
2022-06-03 15:30;20987;724;617;9;0;22337
2022-06-03 16:30;21390;607;628;7;0;22632
2022-06-03 17:30;22251;491;629;5;0;23376
2022-06-03 18:30;22472;452;633;3;0;23560
2022-06-03 19:30;21865;566;634;0;0;23065
2022-06-03 20:30;21175;731;632;0;0;22538
2022-06-03 21:30;20359;818;637;0;0;21814
2022-06-03 22:30;19004;1023;636;0;0;20663
2022-06-03 23:30;17920;969;665;0;0;19554
2022-06-04 00:30;16911;975;666;0;0;18552
2022-06-04 01:30;16365;929;664;0;0;17958
2022-06-04 02:30;16321;793;667;0;0;17781
2022-06-04 03:30;16203;699;663;0;0;17565
2022-06-04 04:30;15773;642;664;0;0;17079
2022-06-04 05:30;16328;577;662;0;0;17567
2022-06-04 06:30;16704;512;663;0;0;17879
2022-06-04 07:30;17641;474;660;3;0;18778
2022-06-04 08:30;18946;319;657;3;0;19925
2022-06-04 09:30;19619;262;652;6;0;20539
2022-06-04 10:30;19932;174;647;8;0;20761
2022-06-04 11:30;19832;398;646;7;0;20883
2022-06-04 12:30;19659;437;646;8;0;20750
2022-06-04 13:30;19450;384;647;9;0;20490
2022-06-04 14:30;18972;521;647;9;0;20149
2022-06-04 15:30;18649;525;643;9;0;19826
2022-06-04 16:30;18911;720;647;6;0;20284
2022-06-04 17:30;19251;718;650;4;0;20623
2022-06-04 18:30;19400;1167;644;3;0;21214
2022-06-04 19:30;19452;878;645;0;0;20975
2022-06-04 20:30;19094;1064;648;0;0;20806
2022-06-04 21:30;19028;1068;652;0;0;20748
2022-06-04 22:30;17440;1191;654;0;0;19285
2022-06-04 23:30;16070;1334;656;0;0;18060
2022-06-05 00:30;15586;1424;654;0;0;17664
2022-06-05 01:30;14963;1434;656;0;0;17053
2022-06-05 02:30;14849;1250;656;0;0;16755
2022-06-05 03:30;15177;1162;655;0;0;16994
2022-06-05 04:30;15274;1260;656;0;0;17190
2022-06-05 05:30;15530;1275;656;0;0;17461
2022-06-05 06:30;15936;1213;656;0;0;17805
2022-06-05 07:30;16729;1066;654;3;0;18452
2022-06-05 08:30;17649;965;651;4;0;19269
2022-06-05 09:30;18260;864;646;7;0;19777
2022-06-05 10:30;18881;875;644;8;0;20408
2022-06-05 11:30;18867;841;649;9;0;20366
2022-06-05 12:30;19170;843;652;7;0;20672
2022-06-05 13:30;18938;758;653;7;0;20356
2022-06-05 14:30;18985;651;651;4;0;20291
2022-06-05 15:30;19489;545;646;5;0;20685
2022-06-05 16:30;19977;417;644;5;0;21043
2022-06-05 17:30;21322;374;645;4;0;22345
2022-06-05 18:30;21501;303;654;2;0;22460
2022-06-05 19:30;21331;297;660;0;0;22288
2022-06-05 20:30;21510;247;663;0;0;22420
2022-06-05 21:30;20695;258;664;0;0;21617
2022-06-05 22:30;19405;209;666;0;0;20280
2022-06-05 23:30;18162;201;664;0;0;19027
2022-06-06 00:30;17776;212;663;0;0;18651
2022-06-06 01:30;16976;170;667;0;0;17813
2022-06-06 02:30;16855;172;669;0;0;17696
2022-06-06 03:30;16597;161;670;0;0;17428
2022-06-06 04:30;16575;209;670;0;0;17454
2022-06-06 05:30;16922;198;668;0;0;17788
2022-06-06 06:30;18488;193;668;0;0;19349
2022-06-06 07:30;20946;120;666;3;0;21735
2022-06-06 08:30;21813;116;664;5;0;22598
2022-06-06 09:30;21846;121;658;8;0;22633
2022-06-06 10:30;21608;167;659;8;0;22442
2022-06-06 11:30;21700;202;657;9;0;22568
2022-06-06 12:30;21833;236;655;9;0;22733
2022-06-06 13:30;21814;290;660;9;0;22773
2022-06-06 14:30;21786;278;661;8;0;22733
2022-06-06 15:30;21573;234;662;8;0;22477
2022-06-06 16:30;22206;168;661;3;0;23038
2022-06-06 17:30;22674;149;661;2;0;23486
2022-06-06 18:30;23167;129;662;2;0;23960
2022-06-06 19:30;23361;113;663;1;0;24138
2022-06-06 20:30;23361;133;665;0;0;24159
2022-06-06 21:30;22297;211;666;0;0;23174
2022-06-06 22:30;20266;316;666;0;0;21248
2022-06-06 23:30;18125;472;666;0;0;19263
2022-06-07 00:30;17274;533;666;0;0;18473
2022-06-07 01:30;16775;481;665;0;0;17921
2022-06-07 02:30;16411;471;667;0;0;17549
2022-06-07 03:30;16451;405;663;0;0;17519
2022-06-07 04:30;16608;408;664;0;0;17680
2022-06-07 05:30;17275;407;659;0;0;18341
2022-06-07 06:30;18791;403;656;0;0;19850
2022-06-07 07:30;20712;432;644;0;0;21788
2022-06-07 08:30;21470;416;640;1;0;22527
2022-06-07 09:30;22085;411;636;2;0;23134
2022-06-07 10:30;21610;484;633;5;0;22732
2022-06-07 11:30;21996;502;634;5;0;23137
2022-06-07 12:30;21938;698;672;4;0;23312
2022-06-07 13:30;21851;860;672;1;0;23384
2022-06-07 14:30;21620;976;672;2;0;23270
2022-06-07 15:30;21723;1077;674;4;0;23478
2022-06-07 16:30;22261;1138;675;1;0;24075
2022-06-07 17:30;22842;1330;682;2;0;24856
2022-06-07 18:30;22576;1368;688;0;0;24632
2022-06-07 19:30;22018;1550;687;0;0;24255
2022-06-07 20:30;21457;1810;694;0;0;23961
2022-06-07 21:30;20655;2049;694;0;0;23398
2022-06-07 22:30;19612;2173;699;0;0;22484
2022-06-07 23:30;17799;2329;695;0;0;20823
2022-06-08 00:30;16217;2495;697;0;0;19409
2022-06-08 01:30;15100;2641;695;0;0;18436
2022-06-08 02:30;14886;2577;695;0;0;18158
2022-06-08 03:30;14871;2532;694;0;0;18097
2022-06-08 04:30;14759;2337;693;0;0;17789
2022-06-08 05:30;15631;2217;694;0;0;18542
2022-06-08 06:30;17927;2154;694;0;0;20775
2022-06-08 07:30;19564;1985;691;1;0;22241
2022-06-08 08:30;19951;1854;688;2;0;22495
2022-06-08 09:30;19854;1853;683;2;0;22392
2022-06-08 10:30;20166;1385;684;4;0;22239
2022-06-08 11:30;20834;1333;681;1;0;22849
2022-06-08 12:30;20795;1318;650;8;0;22771
2022-06-08 13:30;21000;1363;654;7;0;23024
2022-06-08 14:30;20650;1810;657;8;0;23125
2022-06-08 15:30;20958;1416;658;7;0;23039
2022-06-08 16:30;21851;1699;658;7;0;24215
2022-06-08 17:30;22747;1457;661;4;0;24869
2022-06-08 18:30;23109;1355;658;3;0;25125
2022-06-08 19:30;22982;1361;658;1;0;25002
2022-06-08 20:30;22464;1309;657;0;0;24430
2022-06-08 21:30;22153;1256;664;0;0;24073
2022-06-08 22:30;20623;1015;666;0;0;22304
2022-06-08 23:30;19197;877;664;0;0;20738
2022-06-09 00:30;17907;672;662;0;0;19241
2022-06-09 01:30;17595;423;664;0;0;18682
2022-06-09 02:30;17139;323;659;0;0;18121
2022-06-09 03:30;17017;210;654;0;0;17881
2022-06-09 04:30;17183;143;654;0;0;17980
2022-06-09 05:30;18134;77;654;0;0;18865
2022-06-09 06:30;20036;28;654;0;0;20718
2022-06-09 07:30;22036;26;648;0;0;22710
2022-06-09 08:30;22990;49;644;0;0;23683
2022-06-09 09:30;22737;147;644;0;0;23528
2022-06-09 10:30;23128;213;644;1;0;23986
2022-06-09 11:30;23256;232;645;1;0;24134
2022-06-09 12:30;23329;217;668;3;0;24217
2022-06-09 13:30;22518;262;669;3;0;23452
2022-06-09 14:30;22430;296;664;1;0;23391
2022-06-09 15:30;21833;378;668;2;0;22881
2022-06-09 16:30;21915;410;675;7;0;23007
2022-06-09 17:30;23182;378;677;2;0;24239
2022-06-09 18:30;22806;483;674;2;0;23965
2022-06-09 19:30;22083;469;674;0;0;23226
2022-06-09 20:30;21739;623;672;0;0;23034
2022-06-09 21:30;21092;751;679;0;0;22522
2022-06-09 22:30;19804;1097;681;0;0;21582
2022-06-09 23:30;18558;1236;678;0;0;20472
2022-06-10 00:30;17290;1309;677;0;0;19276
2022-06-10 01:30;16455;1268;677;0;0;18400
2022-06-10 02:30;15897;1071;678;0;0;17646
2022-06-10 03:30;15792;1124;677;0;0;17593
2022-06-10 04:30;16140;1070;677;0;0;17887
2022-06-10 05:30;16556;1001;676;0;0;18233
2022-06-10 06:30;18454;1168;674;0;0;20296
2022-06-10 07:30;19329;1412;673;1;0;21415
2022-06-10 08:30;19952;1634;670;1;0;22257
2022-06-10 09:30;19760;1657;671;3;0;22091
2022-06-10 10:30;20229;1721;665;4;0;22619
2022-06-10 11:30;20322;1901;665;6;0;22894
2022-06-10 12:30;19643;1993;673;5;0;22314
2022-06-10 13:30;20154;2019;669;3;0;22845
2022-06-10 14:30;19302;2210;669;7;0;22188
2022-06-10 15:30;19166;1978;672;9;0;21825
2022-06-10 16:30;19116;2390;671;6;0;22183
2022-06-10 17:30;19876;2339;670;5;0;22890
2022-06-10 18:30;20289;2228;681;1;0;23199
2022-06-10 19:30;20065;2237;680;1;0;22983
2022-06-10 20:30;19561;2371;675;0;0;22607
2022-06-10 21:30;18847;2175;679;0;0;21701
2022-06-10 22:30;17271;2733;684;0;0;20688
2022-06-10 23:30;15929;2303;683;0;0;18915
2022-06-11 00:30;14832;2651;685;0;0;18168
2022-06-11 01:30;14463;2526;682;0;0;17671
2022-06-11 02:30;14012;2080;683;0;0;16775
2022-06-11 03:30;14047;1961;682;0;0;16690
2022-06-11 04:30;14032;2228;679;0;0;16939
2022-06-11 05:30;14350;2104;681;0;0;17135
2022-06-11 06:30;15052;1847;680;0;0;17579
2022-06-11 07:30;16603;1761;676;1;0;19041
2022-06-11 08:30;17304;1354;670;5;0;19333
2022-06-11 09:30;18187;1575;673;7;0;20442
2022-06-11 10:30;19124;1636;672;8;0;21440
2022-06-11 11:30;19290;1651;669;9;0;21619
2022-06-11 12:30;19100;1624;661;9;0;21394
2022-06-11 13:30;18838;1768;674;9;0;21289
2022-06-11 14:30;19163;1440;676;6;0;21285
2022-06-11 15:30;19223;1375;676;7;0;21281
2022-06-11 16:30;19473;1287;675;7;0;21442
2022-06-11 17:30;19793;1388;676;4;0;21861
2022-06-11 18:30;20381;901;677;3;0;21962
2022-06-11 19:30;19808;709;680;0;0;21197
2022-06-11 20:30;19129;851;681;0;0;20661
2022-06-11 21:30;18550;1072;685;0;0;20307
2022-06-11 22:30;18079;1053;688;0;0;19820
2022-06-11 23:30;16961;1060;691;0;0;18712
2022-06-12 00:30;16054;1017;689;0;0;17760
2022-06-12 01:30;15734;857;691;0;0;17282
2022-06-12 02:30;15776;673;686;0;0;17135
2022-06-12 03:30;15556;686;685;0;0;16927
2022-06-12 04:30;15757;560;688;0;0;17005
2022-06-12 05:30;15989;399;686;0;0;17074
2022-06-12 06:30;16421;302;687;0;0;17410
2022-06-12 07:30;17770;158;686;2;0;18616
2022-06-12 08:30;18771;89;686;4;0;19550
2022-06-12 09:30;19670;87;684;3;0;20444
2022-06-12 10:30;20289;119;681;7;0;21096
2022-06-12 11:30;20358;254;679;9;0;21300
2022-06-12 12:30;20975;317;679;6;0;21977
2022-06-12 13:30;20810;353;681;5;0;21849
2022-06-12 14:30;20695;365;677;3;0;21740
2022-06-12 15:30;20754;434;676;2;0;21866
2022-06-12 16:30;21688;448;680;2;0;22818
2022-06-12 17:30;22991;321;677;0;0;23989
2022-06-12 18:30;22882;449;680;1;0;24012
2022-06-12 19:30;22223;827;681;0;0;23731
2022-06-12 20:30;21675;891;687;0;0;23253
2022-06-12 21:30;21208;979;689;0;0;22876
2022-06-12 22:30;19615;1158;686;0;0;21459
2022-06-12 23:30;17537;1301;684;0;0;19522
2022-06-13 00:30;16705;1338;686;0;0;18729
2022-06-13 01:30;16099;1546;686;0;0;18331
2022-06-13 02:30;15896;1462;683;0;0;18041
2022-06-13 03:30;15805;1329;685;0;0;17819
2022-06-13 04:30;15895;1427;686;0;0;18008
2022-06-13 05:30;16736;1277;687;0;0;18700
2022-06-13 06:30;18305;1014;683;1;0;20003
2022-06-13 07:30;20402;876;682;2;0;21962
2022-06-13 08:30;21753;706;682;2;0;23143
2022-06-13 09:30;21851;632;678;6;0;23167
2022-06-13 10:30;22284;557;677;9;0;23527
2022-06-13 11:30;21947;894;678;9;0;23528
2022-06-13 12:30;21627;936;676;9;0;23248
2022-06-13 13:30;22067;1083;673;9;0;23832
2022-06-13 14:30;22155;861;672;8;0;23696
2022-06-13 15:30;22699;919;672;8;0;24298
2022-06-13 16:30;23232;956;671;8;0;24867
2022-06-13 17:30;23472;756;673;5;0;24906
2022-06-13 18:30;23525;816;673;3;0;25017
2022-06-13 19:30;23487;692;672;0;0;24851
2022-06-13 20:30;23235;643;675;0;0;24553
2022-06-13 21:30;23109;649;682;0;0;24440
2022-06-13 22:30;21562;628;678;0;0;22868
2022-06-13 23:30;19809;658;675;0;0;21142
2022-06-14 00:30;18276;621;676;0;0;19573
2022-06-14 01:30;17104;628;678;0;0;18410
2022-06-14 02:30;16678;486;675;0;0;17839
2022-06-14 03:30;16430;522;675;0;0;17627
2022-06-14 04:30;16524;505;696;0;0;17725
2022-06-14 05:30;17203;423;727;0;0;18353
2022-06-14 06:30;19354;331;728;0;0;20413
2022-06-14 07:30;21377;257;723;3;0;22360
2022-06-14 08:30;21938;346;722;5;0;23011
2022-06-14 09:30;22257;349;725;7;0;23338
2022-06-14 10:30;22493;383;717;8;0;23601
2022-06-14 11:30;22976;403;723;9;0;24111
2022-06-14 12:30;22665;369;724;9;0;23767
2022-06-14 13:30;23319;433;744;6;0;24502
2022-06-14 14:30;22927;385;740;6;0;24058
2022-06-14 15:30;23312;414;738;9;0;24473
2022-06-14 16:30;24328;339;737;7;0;25411
2022-06-14 17:30;24589;328;737;3;0;25657
2022-06-14 18:30;24679;311;737;1;0;25728
2022-06-14 19:30;24595;361;742;0;0;25698
2022-06-14 20:30;23950;480;747;0;0;25177
2022-06-14 21:30;23556;628;746;0;0;24930
2022-06-14 22:30;22508;706;748;0;0;23962
2022-06-14 23:30;20611;717;744;0;0;22072
2022-06-15 00:30;19198;703;742;0;0;20643
2022-06-15 01:30;18212;674;744;0;0;19630
2022-06-15 02:30;17451;667;744;0;0;18862
2022-06-15 03:30;16967;634;743;0;0;18344
2022-06-15 04:30;17057;590;745;0;0;18392
2022-06-15 05:30;17591;525;744;0;0;18860
2022-06-15 06:30;19764;372;745;1;0;20882
2022-06-15 07:30;21739;205;744;3;0;22691
2022-06-15 08:30;22358;103;746;5;0;23212
2022-06-15 09:30;22891;81;742;7;0;23721
2022-06-15 10:30;23594;161;741;6;0;24502
2022-06-15 11:30;23518;202;743;8;0;24471
2022-06-15 12:30;23216;223;732;8;0;24179
2022-06-15 13:30;22644;220;736;8;0;23608
2022-06-15 14:30;22951;233;735;6;0;23925
2022-06-15 15:30;24110;243;733;4;0;25090
2022-06-15 16:30;23276;235;735;5;0;24251
2022-06-15 17:30;24874;220;736;5;0;25835
2022-06-15 18:30;25297;185;733;3;0;26218
2022-06-15 19:30;24864;224;733;0;0;25821
2022-06-15 20:30;24137;429;735;0;0;25301
2022-06-15 21:30;23725;689;739;0;0;25153
2022-06-15 22:30;21937;835;742;0;0;23514
2022-06-15 23:30;19869;933;739;0;0;21541
2022-06-16 00:30;18580;1255;741;0;0;20576
2022-06-16 01:30;16951;1438;733;0;0;19122
2022-06-16 02:30;15978;1744;736;0;0;18458
2022-06-16 03:30;15248;2058;736;0;0;18042
2022-06-16 04:30;15469;2125;734;0;0;18328
2022-06-16 05:30;15903;2148;735;0;0;18786
2022-06-16 06:30;18210;1909;734;0;0;20853
2022-06-16 07:30;20447;1614;731;1;0;22793
2022-06-16 08:30;21731;1517;729;4;0;23981
2022-06-16 09:30;22261;1464;729;3;0;24457
2022-06-16 10:30;23001;1659;731;1;0;25392
2022-06-16 11:30;22113;2020;730;1;0;24864
2022-06-16 12:30;22473;1999;732;9;0;25213
2022-06-16 13:30;22877;2140;695;4;0;25716
2022-06-16 14:30;22813;2212;694;8;0;25727
2022-06-16 15:30;22442;2026;692;4;0;25164
2022-06-16 16:30;22550;2249;689;1;0;25489
2022-06-16 17:30;23252;1937;687;0;0;25876
2022-06-16 18:30;22771;2198;686;0;0;25655
2022-06-16 19:30;22755;2539;687;0;0;25981
2022-06-16 20:30;21500;2598;689;0;0;24787
2022-06-16 21:30;21244;2591;693;0;0;24528
2022-06-16 22:30;19877;2643;695;0;0;23215
2022-06-16 23:30;18610;2545;693;0;0;21848
2022-06-17 00:30;17093;2455;694;0;0;20242
2022-06-17 01:30;16288;2367;694;0;0;19349
2022-06-17 02:30;15652;2296;693;0;0;18641
2022-06-17 03:30;15209;2222;691;0;0;18122
2022-06-17 04:30;15114;2601;690;0;0;18405
2022-06-17 05:30;15829;2509;689;0;0;19027
2022-06-17 06:30;17667;2524;690;0;0;20881
2022-06-17 07:30;19553;2578;693;0;0;22824
2022-06-17 08:30;20482;2349;692;1;0;23524
2022-06-17 09:30;21087;2319;689;1;0;24096
2022-06-17 10:30;21451;2294;688;1;0;24434
2022-06-17 11:30;21960;1905;688;1;0;24554
2022-06-17 12:30;21622;1873;681;1;0;24177
2022-06-17 13:30;21392;1708;682;1;0;23783
2022-06-17 14:30;20623;1462;681;1;0;22767
2022-06-17 15:30;20988;1425;674;1;0;23088
2022-06-17 16:30;21696;1159;679;3;0;23537
2022-06-17 17:30;21976;1090;680;1;0;23747
2022-06-17 18:30;21794;1008;681;0;0;23483
2022-06-17 19:30;21417;1027;681;0;0;23125
2022-06-17 20:30;21293;811;680;0;0;22784
2022-06-17 21:30;20561;805;684;0;0;22050
2022-06-17 22:30;18808;672;687;0;0;20167
2022-06-17 23:30;17411;710;684;0;0;18805
2022-06-18 00:30;16451;648;685;0;0;17784
2022-06-18 01:30;16154;679;681;0;0;17514
2022-06-18 02:30;16042;681;675;0;0;17398
2022-06-18 03:30;15591;719;677;0;0;16987
2022-06-18 04:30;15595;744;675;0;0;17014
2022-06-18 05:30;15759;754;675;0;0;17188
2022-06-18 06:30;16100;815;677;0;0;17592
2022-06-18 07:30;17071;847;673;0;0;18591
2022-06-18 08:30;18227;803;677;0;0;19707
2022-06-18 09:30;18611;921;676;0;0;20208
2022-06-18 10:30;18622;1044;676;1;0;20343
2022-06-18 11:30;18717;1171;670;1;0;20559
2022-06-18 12:30;18363;1531;707;1;0;20602
2022-06-18 13:30;17596;1811;711;1;0;20119
2022-06-18 14:30;17272;2059;714;1;0;20046
2022-06-18 15:30;17084;2101;712;1;0;19898
2022-06-18 16:30;17082;2127;712;1;0;19922
2022-06-18 17:30;17220;2332;710;1;0;20263
2022-06-18 18:30;17030;2472;713;1;0;20216
2022-06-18 19:30;16837;2051;711;0;0;19599
2022-06-18 20:30;16316;2211;714;0;0;19241
2022-06-18 21:30;15786;2322;718;0;0;18826
2022-06-18 22:30;14744;2251;717;0;0;17712
2022-06-18 23:30;13414;2304;718;0;0;16436
2022-06-19 00:30;12937;2249;719;0;0;15905
2022-06-19 01:30;12585;2193;718;0;0;15496
2022-06-19 02:30;12894;2312;718;0;0;15924
2022-06-19 03:30;13050;2249;719;0;0;16018
2022-06-19 04:30;13075;2276;723;0;0;16074
2022-06-19 05:30;12850;2257;727;0;0;15834
2022-06-19 06:30;13996;2249;727;0;0;16972
2022-06-19 07:30;14023;2192;728;1;0;16944
2022-06-19 08:30;14594;2166;727;2;0;17489
2022-06-19 09:30;15289;2228;725;3;0;18245
2022-06-19 10:30;15578;2204;723;4;0;18509
2022-06-19 11:30;15818;2150;724;4;0;18696
2022-06-19 12:30;16255;1982;738;4;0;18979
2022-06-19 13:30;16542;1922;734;4;0;19202
2022-06-19 14:30;16219;1818;736;4;0;18777
2022-06-19 15:30;16087;1744;737;4;0;18572
2022-06-19 16:30;17296;2045;739;3;0;20083
2022-06-19 17:30;18312;1905;745;3;0;20965
2022-06-19 18:30;19540;1794;745;2;0;22081
2022-06-19 19:30;19486;1734;745;0;0;21965
2022-06-19 20:30;19013;1678;746;0;0;21437
2022-06-19 21:30;19216;1594;746;0;0;21556
2022-06-19 22:30;17956;1506;747;0;0;20209
2022-06-19 23:30;16994;1372;746;0;0;19112
2022-06-20 00:30;16144;1251;746;0;0;18141
2022-06-20 01:30;15445;1159;745;0;0;17349
2022-06-20 02:30;15550;970;741;0;0;17261
2022-06-20 03:30;15734;804;743;0;0;17281
2022-06-20 04:30;16217;719;743;0;0;17679
2022-06-20 05:30;16962;735;744;0;0;18441
2022-06-20 06:30;19468;629;740;0;0;20837
2022-06-20 07:30;20828;642;741;1;0;22212
2022-06-20 08:30;21500;847;739;2;0;23088
2022-06-20 09:30;21585;1041;738;3;0;23367
2022-06-20 10:30;21245;1099;737;3;0;23084
2022-06-20 11:30;21644;961;735;4;0;23344
2022-06-20 12:30;22159;904;739;4;0;23806
2022-06-20 13:30;22307;867;734;4;0;23912
2022-06-20 14:30;22427;681;735;4;0;23847
2022-06-20 15:30;22403;612;738;4;0;23757
2022-06-20 16:30;23186;540;739;3;0;24468
2022-06-20 17:30;23881;415;737;2;0;25035
2022-06-20 18:30;24072;375;744;2;0;25193
2022-06-20 19:30;23659;288;746;0;0;24693
2022-06-20 20:30;23210;305;747;0;0;24262
2022-06-20 21:30;23034;375;748;0;0;24157
2022-06-20 22:30;21674;498;745;0;0;22917
2022-06-20 23:30;19724;516;739;0;0;20979
2022-06-21 00:30;18160;480;740;0;0;19380
2022-06-21 01:30;16917;456;738;0;0;18111
2022-06-21 02:30;16349;340;739;0;0;17428
2022-06-21 03:30;16304;319;739;0;0;17362
2022-06-21 04:30;16425;267;740;0;0;17432
2022-06-21 05:30;17401;301;738;0;0;18440
2022-06-21 06:30;19786;249;736;0;0;20771
2022-06-21 07:30;21825;118;733;0;0;22676
2022-06-21 08:30;21998;62;731;0;0;22791
2022-06-21 09:30;22398;51;733;2;0;23184
2022-06-21 10:30;23276;32;732;2;0;24042
2022-06-21 11:30;23501;27;732;2;0;24262
2022-06-21 12:30;23512;44;732;1;0;24289
2022-06-21 13:30;23743;77;700;1;0;24521
2022-06-21 14:30;23190;107;702;1;0;24000
2022-06-21 15:30;22375;219;700;0;0;23294
2022-06-21 16:30;23024;308;700;0;0;24032
2022-06-21 17:30;23432;399;706;0;0;24537
2022-06-21 18:30;24029;479;707;0;0;25215
2022-06-21 19:30;23627;600;707;0;0;24934
2022-06-21 20:30;23016;859;707;0;0;24582
2022-06-21 21:30;22176;1271;710;0;0;24157
2022-06-21 22:30;20752;1582;707;0;0;23041
2022-06-21 23:30;19557;1696;712;0;0;21965
2022-06-22 00:30;18311;1868;717;0;0;20896
2022-06-22 01:30;17185;1917;715;0;0;19817
2022-06-22 02:30;15955;2029;713;0;0;18697
2022-06-22 03:30;15417;1978;713;0;0;18108
2022-06-22 04:30;15618;1990;713;0;0;18321
2022-06-22 05:30;16600;2052;712;0;0;19364
2022-06-22 06:30;18443;2097;712;0;0;21252
2022-06-22 07:30;20631;1913;712;0;0;23256
2022-06-22 08:30;21722;1551;710;0;0;23983
2022-06-22 09:30;22173;1631;707;1;25;24537
2022-06-22 10:30;22340;1687;706;3;0;24736
2022-06-22 11:30;22774;1748;705;3;0;25230
2022-06-22 12:30;22582;1891;705;3;0;25181
2022-06-22 13:30;22751;1845;702;3;0;25301
2022-06-22 14:30;22344;1844;697;4;0;24889
2022-06-22 15:30;22762;1849;694;3;0;25308
2022-06-22 16:30;23304;1753;696;2;0;25755
2022-06-22 17:30;23547;1822;695;1;0;26065
2022-06-22 18:30;23445;1921;695;0;0;26061
2022-06-22 19:30;23011;2059;700;0;0;25770
2022-06-22 20:30;22564;2266;704;0;0;25534
2022-06-22 21:30;22012;2045;705;0;0;24762
2022-06-22 22:30;20708;2474;701;0;0;23883
2022-06-22 23:30;19061;2461;704;0;0;22226
2022-06-23 00:30;18766;2340;702;0;0;21808
2022-06-23 01:30;17765;2265;703;0;0;20733
2022-06-23 02:30;16730;2229;703;0;0;19662
2022-06-23 03:30;16010;2184;696;0;0;18890
2022-06-23 04:30;16191;2025;694;0;0;18910
2022-06-23 05:30;17630;1906;696;0;0;20232
2022-06-23 06:30;19658;1897;695;0;0;22250
2022-06-23 07:30;21992;1626;693;0;0;24311
2022-06-23 08:30;23223;1274;694;0;0;25191
2022-06-23 09:30;22977;985;699;0;0;24661
2022-06-23 10:30;23201;1053;699;0;0;24953
2022-06-23 11:30;23812;1152;700;0;0;25664
2022-06-23 12:30;23848;833;722;0;0;25403
2022-06-23 13:30;23898;754;723;0;0;25375
2022-06-23 14:30;23874;637;723;0;0;25234
2022-06-23 15:30;23908;407;722;1;0;25038
2022-06-23 16:30;24249;356;723;0;0;25328
2022-06-23 17:30;24513;315;722;0;0;25550
2022-06-23 18:30;24349;396;723;0;0;25468
2022-06-23 19:30;23982;415;721;0;0;25118
2022-06-23 20:30;23621;329;724;0;0;24674
2022-06-23 21:30;23303;594;726;0;0;24623
2022-06-23 22:30;22263;760;725;0;0;23748
2022-06-23 23:30;21144;869;723;0;0;22736
2022-06-24 00:30;20149;918;720;0;0;21787
2022-06-24 01:30;19258;828;722;0;0;20808
2022-06-24 02:30;18293;696;723;0;0;19712
2022-06-24 03:30;17594;577;724;0;0;18895
2022-06-24 04:30;17781;388;720;0;0;18889
2022-06-24 05:30;18771;259;721;0;0;19751
2022-06-24 06:30;20225;219;721;0;0;21165
2022-06-24 07:30;21349;201;721;0;0;22271
2022-06-24 08:30;22260;185;716;1;0;23162
2022-06-24 09:30;22839;161;716;3;0;23719
2022-06-24 10:30;23673;135;712;3;0;24523
2022-06-24 11:30;24115;114;712;3;0;24944
2022-06-24 12:30;24198;121;681;3;0;25003
2022-06-24 13:30;24190;87;681;4;0;24962
2022-06-24 14:30;23745;120;682;4;0;24551
2022-06-24 15:30;23920;130;680;4;0;24734
2022-06-24 16:30;23900;158;680;3;0;24741
2022-06-24 17:30;24030;216;677;2;0;24925
2022-06-24 18:30;23908;268;678;2;0;24856
2022-06-24 19:30;23742;286;678;0;0;24706
2022-06-24 20:30;23320;500;676;0;0;24496
2022-06-24 21:30;22502;826;679;0;0;24007
2022-06-24 22:30;21448;1012;683;0;0;23143
2022-06-24 23:30;20510;1208;682;0;0;22400
2022-06-25 00:30;19179;1443;683;0;0;21305
2022-06-25 01:30;18645;1460;683;0;0;20788
2022-06-25 02:30;18097;1391;683;0;0;20171
2022-06-25 03:30;16729;1291;682;0;0;18702
2022-06-25 04:30;16968;1220;683;0;0;18871
2022-06-25 05:30;16987;1040;682;0;0;18709
2022-06-25 06:30;18265;824;683;0;0;19772
2022-06-25 07:30;19560;587;681;0;0;20828
2022-06-25 08:30;21068;507;679;2;0;22256
2022-06-25 09:30;22706;576;677;2;0;23961
2022-06-25 10:30;22927;691;671;3;0;24292
2022-06-25 11:30;23554;638;672;4;0;24868
2022-06-25 12:30;24233;533;675;4;0;25445
2022-06-25 13:30;24184;471;674;4;0;25333
2022-06-25 14:30;24162;400;674;4;0;25240
2022-06-25 15:30;24083;364;673;3;0;25123
2022-06-25 16:30;24225;352;672;3;0;25252
2022-06-25 17:30;24523;359;673;2;0;25557
2022-06-25 18:30;24185;320;673;2;0;25180
2022-06-25 19:30;24288;184;674;0;0;25146
2022-06-25 20:30;23545;155;678;0;0;24378
2022-06-25 21:30;23920;90;681;0;0;24691
2022-06-25 22:30;22979;62;680;0;0;23721
2022-06-25 23:30;22628;53;682;0;0;23363
2022-06-26 00:30;21066;83;685;0;0;21834
2022-06-26 01:30;20224;191;684;0;0;21099
2022-06-26 02:30;18565;235;681;0;0;19481
2022-06-26 03:30;17657;407;682;0;0;18746
2022-06-26 04:30;17097;681;682;0;0;18460
2022-06-26 05:30;16776;824;683;0;0;18283
2022-06-26 06:30;17241;838;682;0;0;18761
2022-06-26 07:30;19232;716;678;0;0;20626
2022-06-26 08:30;21406;438;673;2;0;22519
2022-06-26 09:30;22495;381;674;3;0;23553
2022-06-26 10:30;23394;332;672;3;0;24401
2022-06-26 11:30;23781;344;674;4;0;24803
2022-06-26 12:30;23860;433;676;4;0;24973
2022-06-26 13:30;23876;534;679;4;0;25093
2022-06-26 14:30;23484;603;677;4;0;24768
2022-06-26 15:30;23050;769;675;3;0;24497
2022-06-26 16:30;23581;862;675;3;0;25121
2022-06-26 17:30;23578;1048;674;0;0;25300
2022-06-26 18:30;23427;1180;678;0;0;25285
2022-06-26 19:30;22842;1328;676;0;0;24846
2022-06-26 20:30;22565;1605;676;0;0;24846
2022-06-26 21:30;22218;1858;682;0;0;24758
2022-06-26 22:30;20362;2118;683;0;0;23163
2022-06-26 23:30;19687;2135;676;0;0;22498
2022-06-27 00:30;18380;2249;682;0;0;21311
2022-06-27 01:30;17717;2341;681;0;0;20739
2022-06-27 02:30;17368;2147;682;0;0;20197
2022-06-27 03:30;16885;1921;681;0;0;19487
2022-06-27 04:30;16750;1865;678;0;0;19293
2022-06-27 05:30;18301;1474;683;0;0;20458
2022-06-27 06:30;20307;1192;682;0;0;22181
2022-06-27 07:30;21661;1019;680;0;0;23360
2022-06-27 08:30;22812;849;679;0;0;24340
2022-06-27 09:30;23185;879;675;2;0;24741
2022-06-27 10:30;23666;1092;676;2;0;25436
2022-06-27 11:30;23165;1313;680;4;0;25162
2022-06-27 12:30;22936;1263;677;4;0;24880
2022-06-27 13:30;22202;1593;682;4;0;24481
2022-06-27 14:30;21892;1894;683;4;0;24473
2022-06-27 15:30;21595;2358;683;4;0;24640
2022-06-27 16:30;21998;2252;685;3;0;24938
2022-06-27 17:30;22514;2157;687;2;0;25360
2022-06-27 18:30;22347;2089;687;2;0;25125
2022-06-27 19:30;22373;1901;690;0;0;24964
2022-06-27 20:30;22288;1740;688;0;0;24716
2022-06-27 21:30;21854;1738;687;0;0;24279
2022-06-27 22:30;20622;1893;686;0;0;23201
2022-06-27 23:30;19611;1821;689;0;0;22121
2022-06-28 00:30;18876;1739;693;0;0;21308
2022-06-28 01:30;18635;1437;691;0;0;20763
2022-06-28 02:30;17862;1491;690;0;0;20043
2022-06-28 03:30;17363;1509;689;0;0;19561
2022-06-28 04:30;17020;1441;688;0;0;19149
2022-06-28 05:30;18550;1260;687;0;0;20497
2022-06-28 06:30;20486;1031;687;0;0;22204
2022-06-28 07:30;21768;890;689;1;0;23348
2022-06-28 08:30;22438;920;685;2;0;24045
2022-06-28 09:30;22085;1129;684;2;0;23900
2022-06-28 10:30;21586;1336;678;1;0;23601
2022-06-28 11:30;22163;1205;681;3;0;24052
2022-06-28 12:30;22417;1191;683;4;0;24295
2022-06-28 13:30;22772;1027;687;4;0;24490
2022-06-28 14:30;22889;996;686;4;0;24575
2022-06-28 15:30;23280;978;689;9;0;24956
2022-06-28 16:30;23425;985;683;6;0;25099
2022-06-28 17:30;24307;863;686;6;0;25862
2022-06-28 18:30;24368;710;685;2;0;25765
2022-06-28 19:30;24501;531;686;0;0;25718
2022-06-28 20:30;24139;657;683;0;0;25479
2022-06-28 21:30;23298;964;686;0;0;24948
2022-06-28 22:30;22055;1237;689;0;0;23981
2022-06-28 23:30;19796;1346;686;0;0;21828
2022-06-29 00:30;18158;1423;687;0;0;20268
2022-06-29 01:30;16975;1476;690;0;0;19141
2022-06-29 02:30;16582;1439;692;0;0;18713
2022-06-29 03:30;16625;1329;691;0;0;18645
2022-06-29 04:30;16597;1230;692;0;0;18519
2022-06-29 05:30;17336;1112;690;0;0;19138
2022-06-29 06:30;19896;880;692;0;0;21468
2022-06-29 07:30;21970;675;689;2;0;23336
2022-06-29 08:30;22949;553;691;5;0;24198
2022-06-29 09:30;23263;712;683;7;0;24665
2022-06-29 10:30;23500;879;684;7;0;25070
2022-06-29 11:30;23415;907;684;9;0;25015
2022-06-29 12:30;23754;815;687;10;0;25266
2022-06-29 13:30;23884;769;686;9;0;25348
2022-06-29 14:30;23710;894;685;8;0;25297
2022-06-29 15:30;23731;1030;685;3;0;25449
2022-06-29 16:30;23572;1027;686;1;0;25286
2022-06-29 17:30;24219;873;684;1;0;25777
2022-06-29 18:30;24493;912;683;1;0;26089
2022-06-29 19:30;24013;863;683;0;0;25559
2022-06-29 20:30;23520;891;683;0;0;25094
2022-06-29 21:30;23451;743;689;0;0;24883
2022-06-29 22:30;22682;534;688;0;0;23904
2022-06-29 23:30;21546;363;690;0;0;22599
2022-06-30 00:30;20375;339;690;0;0;21404
2022-06-30 01:30;18796;464;690;0;0;19950
2022-06-30 02:30;17963;471;689;0;0;19123
2022-06-30 03:30;17799;616;689;0;0;19104
2022-06-30 04:30;17290;664;688;0;0;18642
2022-06-30 05:30;17968;705;691;0;0;19364
2022-06-30 06:30;20339;638;689;0;0;21666
2022-06-30 07:30;21911;554;685;2;0;23152
2022-06-30 08:30;22055;318;689;6;0;23068
2022-06-30 09:30;23429;282;686;6;0;24403
2022-06-30 10:30;24148;283;681;8;0;25120
2022-06-30 11:30;23915;358;683;6;0;24962
2022-06-30 12:30;23896;398;683;6;0;24983
2022-06-30 13:30;23671;296;673;6;0;24646
2022-06-30 14:30;24238;174;670;9;0;25091
2022-06-30 15:30;24040;90;673;5;0;24808
2022-06-30 16:30;24335;82;678;1;0;25096
2022-06-30 17:30;24602;135;680;1;0;25418
2022-06-30 18:30;24392;154;685;2;0;25233
2022-06-30 19:30;24181;223;686;1;0;25091
2022-06-30 20:30;23951;272;687;0;0;24910
2022-06-30 21:30;23805;270;690;0;0;24765
2022-06-30 22:30;22261;494;691;0;0;23446
2022-06-30 23:30;20364;780;693;0;0;21837
2022-07-01 00:30;18574;1081;693;0;0;20348
2022-07-01 01:30;17406;1204;685;0;0;19295
2022-07-01 02:30;16831;1510;687;0;0;19028
2022-07-01 03:30;16461;1629;692;0;0;18782
2022-07-01 04:30;16115;1835;691;0;0;18641
2022-07-01 05:30;15974;1893;687;0;0;18554
2022-07-01 06:30;16275;1875;688;0;0;18838
2022-07-01 07:30;17704;1726;687;1;0;20118
2022-07-01 08:30;18730;1557;684;2;0;20973
2022-07-01 09:30;20559;1478;679;5;0;22721
2022-07-01 10:30;21839;1561;676;3;0;24079
2022-07-01 11:30;22019;1568;678;4;0;24269
2022-07-01 12:30;22559;1466;655;5;0;24685
2022-07-01 13:30;22960;1388;656;4;0;25008
2022-07-01 14:30;22507;1470;659;4;0;24640
2022-07-01 15:30;22732;1070;658;2;0;24462
2022-07-01 16:30;22912;1119;655;4;0;24690
2022-07-01 17:30;22790;1382;656;5;0;24833
2022-07-01 18:30;22937;1523;653;1;0;25114
2022-07-01 19:30;22542;1468;651;0;0;24661
2022-07-01 20:30;21687;1469;653;0;0;23809
2022-07-01 21:30;22211;1234;655;0;0;24100
2022-07-01 22:30;21359;1211;657;0;0;23227
2022-07-01 23:30;20484;1305;655;0;0;22444
2022-07-02 00:30;19255;1199;655;0;0;21109
2022-07-02 01:30;18383;1230;648;0;0;20261
2022-07-02 02:30;17381;1451;653;0;0;19485
2022-07-02 03:30;16782;1520;649;0;0;18951
2022-07-02 04:30;16822;1478;646;0;0;18946
2022-07-02 05:30;16780;1524;644;0;0;18948
2022-07-02 06:30;17748;1381;647;0;0;19776
2022-07-02 07:30;19078;1225;645;1;0;20949
2022-07-02 08:30;20665;1146;648;5;0;22464
2022-07-02 09:30;21761;1262;646;7;0;23676
2022-07-02 10:30;22038;1408;644;8;0;24098
2022-07-02 11:30;22295;1263;646;10;0;24214
2022-07-02 12:30;22071;1518;615;10;0;24214
2022-07-02 13:30;21855;1416;616;10;0;23897
2022-07-02 14:30;21110;1409;614;9;0;23142
2022-07-02 15:30;21633;1477;615;8;0;23733
2022-07-02 16:30;21999;1560;608;6;0;24173
2022-07-02 17:30;22160;1652;605;4;0;24421
2022-07-02 18:30;21812;1629;613;2;0;24056
2022-07-02 19:30;21753;1549;616;0;0;23918
2022-07-02 20:30;21009;1657;610;0;0;23276
2022-07-02 21:30;21232;1545;614;0;0;23391
2022-07-02 22:30;20197;1701;619;0;0;22517
2022-07-02 23:30;19463;1510;620;0;0;21593
2022-07-03 00:30;18315;1302;619;0;0;20236
2022-07-03 01:30;17374;1188;618;0;0;19180
2022-07-03 02:30;17139;1117;619;0;0;18875
2022-07-03 03:30;16910;807;617;0;0;18334
2022-07-03 04:30;16588;767;616;0;0;17971
2022-07-03 05:30;16597;723;616;0;0;17936
2022-07-03 06:30;17017;641;618;0;0;18276
2022-07-03 07:30;17789;605;615;1;0;19010
2022-07-03 08:30;19180;648;616;3;0;20447
2022-07-03 09:30;20784;889;612;6;0;22291
2022-07-03 10:30;21226;1138;614;8;0;22986
2022-07-03 11:30;20670;1276;615;9;0;22570
2022-07-03 12:30;20431;1493;615;10;0;22549
2022-07-03 13:30;20775;1556;611;10;0;22952
2022-07-03 14:30;20715;1835;612;10;0;23172
2022-07-03 15:30;20857;1843;612;9;0;23321
2022-07-03 16:30;21295;2214;610;7;0;24126
2022-07-03 17:30;22425;1950;612;5;0;24992
2022-07-03 18:30;22237;1625;612;3;0;24477
2022-07-03 19:30;22233;1879;610;1;0;24723
2022-07-03 20:30;22010;1806;613;0;0;24429
2022-07-03 21:30;22044;1707;611;0;0;24362
2022-07-03 22:30;20910;1784;613;0;0;23307
2022-07-03 23:30;19652;1808;613;0;0;22073
2022-07-04 00:30;18804;1782;611;0;0;21197
2022-07-04 01:30;17254;1892;611;0;0;19757
2022-07-04 02:30;16402;1896;612;0;0;18910
2022-07-04 03:30;16092;1819;608;0;0;18519
2022-07-04 04:30;16182;1882;605;0;0;18669
2022-07-04 05:30;17590;1880;609;0;0;20079
2022-07-04 06:30;19278;1922;610;0;0;21810
2022-07-04 07:30;20816;2023;605;1;0;23445
2022-07-04 08:30;21075;2360;605;5;0;24045
2022-07-04 09:30;21435;2078;603;7;0;24123
2022-07-04 10:30;22201;2120;602;8;0;24931
2022-07-04 11:30;22116;2525;612;9;0;25262
2022-07-04 12:30;22096;2524;620;10;0;25250
2022-07-04 13:30;21944;2169;620;10;0;24743
2022-07-04 14:30;21858;2026;620;10;0;24514
2022-07-04 15:30;22416;1983;619;10;0;25028
2022-07-04 16:30;22705;2361;617;8;0;25691
2022-07-04 17:30;23383;2170;617;4;0;26174
2022-07-04 18:30;23900;1799;612;3;0;26314
2022-07-04 19:30;23593;1566;611;1;0;25771
2022-07-04 20:30;23233;1630;614;0;0;25477
2022-07-04 21:30;22730;1750;615;0;0;25095
2022-07-04 22:30;21586;1678;622;0;0;23886
2022-07-04 23:30;19877;1389;620;0;0;21886
2022-07-05 00:30;18899;1264;620;0;0;20783
2022-07-05 01:30;18051;1222;619;0;0;19892
2022-07-05 02:30;17100;1361;619;0;0;19080
2022-07-05 03:30;16612;1453;618;0;0;18683
2022-07-05 04:30;16586;1365;616;0;0;18567
2022-07-05 05:30;17614;1111;615;0;0;19340
2022-07-05 06:30;20001;845;614;0;0;21460
2022-07-05 07:30;21355;559;612;1;0;22527
2022-07-05 08:30;21716;584;611;2;0;22913
2022-07-05 09:30;22565;891;611;2;0;24069
2022-07-05 10:30;22954;1172;612;2;0;24740
2022-07-05 11:30;22024;1561;610;1;0;24196
2022-07-05 12:30;21895;1559;630;2;0;24086
2022-07-05 13:30;22275;1550;629;3;0;24457
2022-07-05 14:30;22278;1427;627;6;0;24338
2022-07-05 15:30;22717;1419;622;1;0;24759
2022-07-05 16:30;23308;1203;620;2;0;25133
2022-07-05 17:30;24120;969;623;1;0;25713
2022-07-05 18:30;24375;576;626;1;0;25578
2022-07-05 19:30;24217;423;626;0;0;25266
2022-07-05 20:30;23858;364;630;0;0;24852
2022-07-05 21:30;23680;367;629;0;0;24676
2022-07-05 22:30;22376;285;630;0;0;23291
2022-07-05 23:30;21413;294;627;0;0;22334
2022-07-06 00:30;19585;222;629;0;0;20436
2022-07-06 01:30;18547;309;629;0;0;19485
2022-07-06 02:30;18885;343;621;0;0;19849
2022-07-06 03:30;18316;347;623;0;0;19286
2022-07-06 04:30;18021;423;620;0;0;19064
2022-07-06 05:30;19106;422;617;0;0;20145
2022-07-06 06:30;20518;605;610;0;0;21733
2022-07-06 07:30;22143;664;609;1;0;23417
2022-07-06 08:30;21942;652;607;2;0;23203
2022-07-06 09:30;22572;639;606;6;0;23823
2022-07-06 10:30;22604;652;607;6;0;23869
2022-07-06 11:30;22963;691;611;10;0;24275
2022-07-06 12:30;23157;761;611;6;0;24535
2022-07-06 13:30;23076;802;611;7;0;24496
2022-07-06 14:30;22948;870;612;9;0;24439
2022-07-06 15:30;23142;956;613;3;0;24714
2022-07-06 16:30;21974;909;610;3;0;23496
2022-07-06 17:30;22661;831;612;3;0;24107
2022-07-06 18:30;23147;642;614;3;0;24406
2022-07-06 19:30;22756;447;616;1;0;23820
2022-07-06 20:30;22431;497;617;0;0;23545
2022-07-06 21:30;21977;650;618;0;0;23245
2022-07-06 22:30;20826;807;622;0;0;22255
2022-07-06 23:30;18930;940;622;0;0;20492
2022-07-07 00:30;18464;892;625;0;0;19981
2022-07-07 01:30;18861;768;626;0;0;20255
2022-07-07 02:30;18424;638;624;0;0;19686
2022-07-07 03:30;17727;501;625;0;0;18853
2022-07-07 04:30;17952;436;627;0;0;19015
2022-07-07 05:30;18554;396;624;0;0;19574
2022-07-07 06:30;20435;254;625;0;0;21314
2022-07-07 07:30;22631;123;625;2;0;23381
2022-07-07 08:30;23904;70;622;4;0;24600
2022-07-07 09:30;23884;147;624;5;0;24660
2022-07-07 10:30;24168;192;618;8;0;24986
2022-07-07 11:30;24701;211;617;8;0;25537
2022-07-07 12:30;24749;243;632;6;0;25630
2022-07-07 13:30;24200;252;629;6;0;25087
2022-07-07 14:30;24289;280;631;9;0;25209
2022-07-07 15:30;24270;294;629;9;0;25202
2022-07-07 16:30;24031;284;627;7;0;24949
2022-07-07 17:30;24721;297;630;5;0;25653
2022-07-07 18:30;24955;216;634;3;0;25808
2022-07-07 19:30;24736;181;635;0;0;25552
2022-07-07 20:30;24691;117;636;0;0;25444
2022-07-07 21:30;24326;153;636;0;0;25115
2022-07-07 22:30;23321;195;639;0;0;24155
2022-07-07 23:30;22133;228;639;0;0;23000
2022-07-08 00:30;20991;237;641;0;0;21869
2022-07-08 01:30;20436;363;640;0;0;21439
2022-07-08 02:30;19356;417;644;0;0;20417
2022-07-08 03:30;18783;545;644;0;0;19972
2022-07-08 04:30;18908;586;641;0;0;20135
2022-07-08 05:30;19038;712;642;0;0;20392
2022-07-08 06:30;20434;734;639;1;0;21808
2022-07-08 07:30;22840;543;638;2;0;24023
2022-07-08 08:30;23900;444;639;4;0;24987
2022-07-08 09:30;24395;385;637;7;0;25424
2022-07-08 10:30;24488;381;639;8;0;25516
2022-07-08 11:30;24195;479;638;9;0;25321
2022-07-08 12:30;24200;532;640;10;0;25382
2022-07-08 13:30;24042;679;633;6;0;25360
2022-07-08 14:30;23504;861;632;9;0;25006
2022-07-08 15:30;23237;1098;628;9;0;24972
2022-07-08 16:30;22997;1192;629;6;0;24824
2022-07-08 17:30;22934;1030;628;5;0;24597
2022-07-08 18:30;22719;1145;630;3;0;24497
2022-07-08 19:30;22672;1204;632;0;0;24508
2022-07-08 20:30;22173;1560;633;0;0;24366
2022-07-08 21:30;21702;1584;634;0;0;23920
2022-07-08 22:30;21071;1692;636;0;0;23399
2022-07-08 23:30;20219;1700;634;0;0;22553
2022-07-09 00:30;18622;1809;636;0;0;21067
2022-07-09 01:30;17760;1727;635;0;0;20122
2022-07-09 02:30;16823;1617;635;0;0;19075
2022-07-09 03:30;16441;1574;635;0;0;18650
2022-07-09 04:30;16477;1531;634;0;0;18642
2022-07-09 05:30;16180;1604;631;0;0;18415
2022-07-09 06:30;16988;1448;632;0;0;19068
2022-07-09 07:30;18134;1525;628;1;0;20288
2022-07-09 08:30;19387;1552;623;5;0;21567
2022-07-09 09:30;20929;1426;625;7;0;22987
2022-07-09 10:30;21018;1417;622;8;0;23065
2022-07-09 11:30;20926;1461;623;9;0;23019
2022-07-09 12:30;21119;1579;617;9;0;23324
2022-07-09 13:30;20590;1674;618;9;0;22891
2022-07-09 14:30;20053;1772;614;9;0;22448
2022-07-09 15:30;20176;1966;613;9;0;22764
2022-07-09 16:30;21014;2029;612;7;0;23662
2022-07-09 17:30;21092;1676;618;5;0;23391
2022-07-09 18:30;21350;1942;616;3;0;23911
2022-07-09 19:30;21503;1688;618;1;0;23810
2022-07-09 20:30;21166;1591;613;0;0;23370
2022-07-09 21:30;21293;1543;618;0;0;23454
2022-07-09 22:30;20496;1398;622;0;0;22516
2022-07-09 23:30;19768;1330;620;0;0;21718
2022-07-10 00:30;19340;1226;620;0;0;21186
2022-07-10 01:30;18404;1167;621;0;0;20192
2022-07-10 02:30;17521;1110;620;0;0;19251
2022-07-10 03:30;16776;1037;621;0;0;18434
2022-07-10 04:30;16957;1009;618;0;0;18584
2022-07-10 05:30;16584;986;614;0;0;18184
2022-07-10 06:30;16852;888;614;0;0;18354
2022-07-10 07:30;17545;746;609;1;0;18901
2022-07-10 08:30;19023;687;607;4;0;20321
2022-07-10 09:30;19939;816;606;6;0;21367
2022-07-10 10:30;21277;988;609;8;0;22882
2022-07-10 11:30;21527;1039;609;9;0;23184
2022-07-10 12:30;21402;1215;595;8;0;23220
2022-07-10 13:30;21557;1259;601;8;0;23425
2022-07-10 14:30;21210;1217;602;7;0;23036
2022-07-10 15:30;21893;1236;601;8;0;23738
2022-07-10 16:30;22885;1193;598;7;0;24683
2022-07-10 17:30;23143;1196;599;6;0;24944
2022-07-10 18:30;23434;1094;598;3;0;25129
2022-07-10 19:30;23325;1063;599;1;0;24988
2022-07-10 20:30;22685;1393;599;0;0;24677
2022-07-10 21:30;22093;1754;603;0;0;24450
2022-07-10 22:30;20560;2039;605;0;0;23204
2022-07-10 23:30;19733;2070;600;0;0;22403
2022-07-11 00:30;18924;1842;602;0;0;21368
2022-07-11 01:30;18273;1805;599;0;0;20677
2022-07-11 02:30;17130;1904;599;0;0;19633
2022-07-11 03:30;16483;1885;599;0;0;18967
2022-07-11 04:30;16445;1722;598;0;0;18765
2022-07-11 05:30;18022;1655;596;0;0;20273
2022-07-11 06:30;20265;1584;598;0;0;22447
2022-07-11 07:30;22235;1311;594;1;0;24141
2022-07-11 08:30;23317;1149;591;2;0;25059
2022-07-11 09:30;23709;1073;587;5;0;25374
2022-07-11 10:30;23368;1194;582;8;0;25152
2022-07-11 11:30;24417;1232;585;9;0;26243
2022-07-11 12:30;24420;1224;586;9;0;26239
2022-07-11 13:30;24189;1320;585;5;0;26099
2022-07-11 14:30;24123;1272;587;5;0;25987
2022-07-11 15:30;24278;1210;589;4;0;26081
2022-07-11 16:30;24646;1248;584;7;0;26485
2022-07-11 17:30;25258;1296;586;5;0;27145
2022-07-11 18:30;25199;1235;588;3;0;27025
2022-07-11 19:30;24372;1398;591;1;0;26362
2022-07-11 20:30;23717;1714;590;0;0;26021
2022-07-11 21:30;23049;1928;591;0;0;25568
2022-07-11 22:30;22065;2034;596;0;0;24695
2022-07-11 23:30;20997;1990;597;0;0;23584
2022-07-12 00:30;19210;2174;600;0;0;21984
2022-07-12 01:30;18756;2402;601;0;0;21759
2022-07-12 02:30;17948;2567;600;0;0;21115
2022-07-12 03:30;17785;2586;598;0;0;20969
2022-07-12 04:30;17363;2282;592;0;0;20237
2022-07-12 05:30;18068;2784;588;0;0;21440
2022-07-12 06:30;19589;2573;583;0;0;22745
2022-07-12 07:30;21337;2694;582;0;0;24613
2022-07-12 08:30;21936;2667;577;1;0;25181
2022-07-12 09:30;22564;2489;572;1;0;25626
2022-07-12 10:30;23165;2248;569;2;0;25984
2022-07-12 11:30;23774;2076;574;5;0;26429
2022-07-12 12:30;23743;2135;574;7;0;26459
2022-07-12 13:30;23388;2082;573;7;0;26050
2022-07-12 14:30;22729;2338;527;8;0;25602
2022-07-12 15:30;22680;2610;526;3;0;25819
2022-07-12 16:30;22718;2603;527;2;0;25850
2022-07-12 17:30;22741;2659;525;5;0;25930
2022-07-12 18:30;22347;2488;524;3;0;25362
2022-07-12 19:30;22126;2423;531;0;0;25080
2022-07-12 20:30;22129;2175;534;0;0;24838
2022-07-12 21:30;22316;2264;537;0;0;25117
2022-07-12 22:30;21111;2357;545;0;0;24013
2022-07-12 23:30;20089;2227;546;0;0;22862
2022-07-13 00:30;19421;1807;550;0;0;21778
2022-07-13 01:30;18267;2225;550;0;0;21042
2022-07-13 02:30;18298;2122;550;0;0;20970
2022-07-13 03:30;18309;1956;551;0;0;20816
2022-07-13 04:30;18311;1822;550;0;0;20683
2022-07-13 05:30;18367;1834;548;0;0;20749
2022-07-13 06:30;20640;1749;550;0;0;22939
2022-07-13 07:30;22027;1642;546;1;0;24216
2022-07-13 08:30;23173;1444;549;3;0;25169
2022-07-13 09:30;23614;1417;547;6;0;25584
2022-07-13 10:30;23612;1456;542;8;0;25618
2022-07-13 11:30;23473;1689;545;8;0;25715
2022-07-13 12:30;23482;1710;530;9;0;25731
2022-07-13 13:30;23515;1690;531;9;0;25745
2022-07-13 14:30;23407;1615;528;9;0;25559
2022-07-13 15:30;23673;1438;528;9;0;25648
2022-07-13 16:30;23964;1230;530;7;0;25731
2022-07-13 17:30;24745;993;529;4;0;26271
2022-07-13 18:30;24766;689;530;2;0;25987
2022-07-13 19:30;24725;416;530;0;0;25671
2022-07-13 20:30;24339;431;531;0;0;25301
2022-07-13 21:30;24329;350;534;0;0;25213
2022-07-13 22:30;23614;291;538;0;0;24443
2022-07-13 23:30;22277;190;538;0;0;23005
2022-07-14 00:30;21416;115;534;0;0;22065
2022-07-14 01:30;20673;120;531;0;0;21324
2022-07-14 02:30;20266;68;527;0;0;20861
2022-07-14 03:30;19122;70;529;0;0;19721
2022-07-14 04:30;19574;43;531;0;0;20148
2022-07-14 05:30;20625;30;530;0;0;21185
2022-07-14 06:30;22230;32;529;0;0;22791
2022-07-14 07:30;23891;2;528;1;0;24422
2022-07-14 08:30;24594;-10;525;3;0;25112
2022-07-14 09:30;24710;-10;525;4;0;25229
2022-07-14 10:30;25024;8;522;4;0;25558
2022-07-14 11:30;25124;20;522;8;0;25674
2022-07-14 12:30;25236;25;527;5;0;25793
2022-07-14 13:30;25327;16;552;4;0;25899
2022-07-14 14:30;24700;29;549;3;0;25281
2022-07-14 15:30;24618;20;549;2;0;25189
2022-07-14 16:30;24916;46;552;7;0;25521
2022-07-14 17:30;25250;73;551;3;0;25877
2022-07-14 18:30;25488;50;551;3;0;26092
2022-07-14 19:30;25227;102;555;0;0;25884
2022-07-14 20:30;24565;195;555;0;0;25315
2022-07-14 21:30;24363;297;555;0;0;25215
2022-07-14 22:30;23366;386;558;0;0;24310
2022-07-14 23:30;22008;486;557;0;0;23051
2022-07-15 00:30;20975;685;556;0;0;22216
2022-07-15 01:30;20089;730;553;0;0;21372
2022-07-15 02:30;18928;830;551;0;0;20309
2022-07-15 03:30;18185;751;554;0;0;19490
2022-07-15 04:30;18101;781;555;0;0;19437
2022-07-15 05:30;19106;820;553;0;0;20479
2022-07-15 06:30;21154;791;553;0;0;22498
2022-07-15 07:30;22867;680;551;1;0;24099
2022-07-15 08:30;23722;456;549;4;0;24731
2022-07-15 09:30;23872;351;544;6;0;24773
2022-07-15 10:30;24188;419;548;8;0;25163
2022-07-15 11:30;24557;676;549;9;0;25791
2022-07-15 12:30;24446;906;557;9;0;25918
2022-07-15 13:30;24191;1081;557;7;0;25836
2022-07-15 14:30;23775;1404;559;8;0;25746
2022-07-15 15:30;23480;1574;558;8;0;25620
2022-07-15 16:30;23372;1616;556;7;0;25551
2022-07-15 17:30;23928;1659;557;4;0;26148
2022-07-15 18:30;23957;1300;557;2;0;25816
2022-07-15 19:30;23421;1416;559;1;0;25397
2022-07-15 20:30;23053;1468;563;0;0;25084
2022-07-15 21:30;22907;1460;563;0;0;24930
2022-07-15 22:30;21938;1420;568;0;0;23926
2022-07-15 23:30;20891;1391;565;0;0;22847
2022-07-16 00:30;19944;1429;564;0;0;21937
2022-07-16 01:30;18731;1352;565;0;0;20648
2022-07-16 02:30;17999;1318;563;0;0;19880
2022-07-16 03:30;17777;1309;559;0;0;19645
2022-07-16 04:30;17482;1355;558;0;0;19395
2022-07-16 05:30;17881;1240;559;0;0;19680
2022-07-16 06:30;18093;1247;561;0;0;19901
2022-07-16 07:30;20201;944;558;1;0;21704
2022-07-16 08:30;21406;637;550;4;0;22597
2022-07-16 09:30;23022;503;551;6;0;24082
2022-07-16 10:30;23329;764;551;8;0;24652
2022-07-16 11:30;23486;916;548;9;0;24959
2022-07-16 12:30;23555;1140;592;9;0;25296
2022-07-16 13:30;23113;1247;594;9;0;24963
2022-07-16 14:30;22406;1300;597;9;0;24312
2022-07-16 15:30;22689;1449;600;8;0;24746
2022-07-16 16:30;22869;1445;602;7;0;24923
2022-07-16 17:30;23308;1367;601;5;0;25281
2022-07-16 18:30;23713;1085;604;3;0;25405
2022-07-16 19:30;23440;975;607;0;0;25022
2022-07-16 20:30;22722;1036;607;0;0;24365
2022-07-16 21:30;22265;1342;613;0;0;24220
2022-07-16 22:30;21422;1398;618;0;0;23438
2022-07-16 23:30;20382;1509;615;0;0;22506
2022-07-17 00:30;20400;1432;612;0;0;22444
2022-07-17 01:30;19310;1411;607;0;0;21328
2022-07-17 02:30;18885;1357;604;0;0;20846
2022-07-17 03:30;18780;1245;599;0;0;20624
2022-07-17 04:30;18561;1068;597;0;0;20226
2022-07-17 05:30;18224;1046;595;0;0;19865
2022-07-17 06:30;19245;762;595;0;0;20602
2022-07-17 07:30;20151;486;592;1;0;21230
2022-07-17 08:30;21755;385;592;4;0;22736
2022-07-17 09:30;22914;481;594;6;0;23995
2022-07-17 10:30;24061;583;591;8;0;25243
2022-07-17 11:30;24142;840;593;9;0;25584
2022-07-17 12:30;24205;1129;597;8;0;25939
2022-07-17 13:30;23906;1300;625;9;0;25840
2022-07-17 14:30;23773;1409;627;9;0;25818
2022-07-17 15:30;23873;1314;628;9;0;25824
2022-07-17 16:30;24061;1341;627;7;0;26036
2022-07-17 17:30;24699;1275;630;5;0;26609
2022-07-17 18:30;24742;1136;632;2;0;26512
2022-07-17 19:30;24441;1105;632;0;0;26178
2022-07-17 20:30;23956;1140;634;0;0;25730
2022-07-17 21:30;23485;1323;638;0;0;25446
2022-07-17 22:30;22487;1444;641;0;0;24572
2022-07-17 23:30;21380;1452;639;0;0;23471
2022-07-18 00:30;20500;1477;639;0;0;22616
2022-07-18 01:30;19822;1516;636;0;0;21974
2022-07-18 02:30;19305;1577;632;0;0;21514
2022-07-18 03:30;18777;1486;632;0;0;20895
2022-07-18 04:30;18858;1449;631;0;0;20938
2022-07-18 05:30;19672;1397;631;0;0;21700
2022-07-18 06:30;21143;1224;629;0;0;22996
2022-07-18 07:30;22974;982;627;1;0;24584
2022-07-18 08:30;24273;658;626;1;0;25558
2022-07-18 09:30;24820;519;630;2;0;25971
2022-07-18 10:30;25319;673;623;5;0;26620
2022-07-18 11:30;25472;745;623;3;0;26843
2022-07-18 12:30;25467;825;598;2;0;26892
2022-07-18 13:30;25492;772;596;2;0;26862
2022-07-18 14:30;25426;769;595;1;0;26791
2022-07-18 15:30;25070;803;587;1;0;26461
2022-07-18 16:30;25323;755;587;1;0;26666
2022-07-18 17:30;25746;657;593;0;0;26996
2022-07-18 18:30;26059;474;596;0;0;27129
2022-07-18 19:30;25102;585;598;0;0;26285
2022-07-18 20:30;24808;769;595;0;0;26172
2022-07-18 21:30;23873;875;600;0;0;25348
2022-07-18 22:30;22864;974;606;0;0;24444
2022-07-18 23:30;21811;830;604;0;0;23245
2022-07-19 00:30;20953;775;607;0;0;22335
2022-07-19 01:30;20240;720;605;0;0;21565
2022-07-19 02:30;19614;635;601;0;0;20850
2022-07-19 03:30;18784;608;600;0;0;19992
2022-07-19 04:30;19241;570;600;0;0;20411
2022-07-19 05:30;19834;812;601;0;0;21247
2022-07-19 06:30;21375;841;601;0;0;22817
2022-07-19 07:30;23130;807;599;0;0;24536
2022-07-19 08:30;23869;837;595;1;0;25302
2022-07-19 09:30;24280;728;598;2;0;25608
2022-07-19 10:30;24755;686;593;7;0;26041
2022-07-19 11:30;25231;714;593;9;0;26547
2022-07-19 12:30;25432;871;599;9;0;26911
2022-07-19 13:30;24993;1259;582;9;0;26843
2022-07-19 14:30;24783;1346;585;9;0;26723
2022-07-19 15:30;24399;1306;583;8;0;26296
2022-07-19 16:30;24438;1835;582;6;0;26861
2022-07-19 17:30;24933;1673;582;5;0;27193
2022-07-19 18:30;24371;1914;585;2;0;26872
2022-07-19 19:30;24369;1697;585;1;0;26652
2022-07-19 20:30;23517;1796;586;0;0;25899
2022-07-19 21:30;22844;2228;587;0;0;25659
2022-07-19 22:30;21808;2066;588;0;0;24462
2022-07-19 23:30;20125;2066;582;0;0;22773
2022-07-20 00:30;19309;2204;584;0;0;22097
2022-07-20 01:30;19149;2168;584;0;0;21901
2022-07-20 02:30;18812;2165;583;0;0;21560
2022-07-20 03:30;17255;2158;579;0;0;19992
2022-07-20 04:30;17599;2163;578;0;0;20340
2022-07-20 05:30;18410;2030;580;0;0;21020
2022-07-20 06:30;20115;1867;581;0;0;22563
2022-07-20 07:30;22054;1574;577;1;0;24206
2022-07-20 08:30;23192;1441;574;4;0;25211
2022-07-20 09:30;23524;1778;574;6;0;25882
2022-07-20 10:30;23313;1736;572;8;0;25629
2022-07-20 11:30;24207;1719;572;6;0;26504
2022-07-20 12:30;24538;1682;575;9;0;26804
2022-07-20 13:30;24370;1685;590;7;0;26652
2022-07-20 14:30;24298;1621;584;7;0;26510
2022-07-20 15:30;24678;1563;583;8;0;26832
2022-07-20 16:30;25033;1637;588;4;0;27262
2022-07-20 17:30;25497;1377;590;5;0;27469
2022-07-20 18:30;25567;1114;589;1;0;27271
2022-07-20 19:30;25075;934;591;0;0;26600
2022-07-20 20:30;24384;1171;592;0;0;26147
2022-07-20 21:30;24582;1281;596;0;0;26459
2022-07-20 22:30;23701;1076;601;0;0;25378
2022-07-20 23:30;22634;919;597;0;0;24150
2022-07-21 00:30;21686;875;595;0;0;23156
2022-07-21 01:30;20978;693;593;0;0;22264
2022-07-21 02:30;19832;645;590;0;0;21067
2022-07-21 03:30;19423;718;588;0;0;20729
2022-07-21 04:30;19248;901;585;0;0;20734
2022-07-21 05:30;19687;1082;584;0;0;21353
2022-07-21 06:30;21418;1369;587;0;0;23374
2022-07-21 07:30;22921;1499;584;1;0;25005
2022-07-21 08:30;24431;1211;581;1;0;26224
2022-07-21 09:30;24953;1122;580;5;0;26660
2022-07-21 10:30;25153;1355;573;3;0;27084
2022-07-21 11:30;25433;1477;578;5;0;27493
2022-07-21 12:30;25563;1539;633;9;0;27744
2022-07-21 13:30;25482;1728;632;9;0;27851
2022-07-21 14:30;24734;1696;632;9;0;27071
2022-07-21 15:30;24650;1711;630;7;0;26998
2022-07-21 16:30;25134;1565;629;6;0;27334
2022-07-21 17:30;25149;1889;632;5;0;27675
2022-07-21 18:30;24826;1858;633;2;0;27319
2022-07-21 19:30;24058;2231;634;1;0;26924
2022-07-21 20:30;23772;2069;636;0;0;26477
2022-07-21 21:30;23592;1916;641;0;0;26149
2022-07-21 22:30;22521;2169;645;0;0;25335
2022-07-21 23:30;21234;2211;640;0;0;24085
2022-07-22 00:30;20251;2279;642;0;0;23172
2022-07-22 01:30;19295;2131;642;0;0;22068
2022-07-22 02:30;19177;1941;646;0;0;21764
2022-07-22 03:30;18272;2214;646;0;0;21132
2022-07-22 04:30;17797;2080;643;0;0;20520
2022-07-22 05:30;19098;1762;645;0;0;21505
2022-07-22 06:30;20406;1809;643;0;0;22858
2022-07-22 07:30;22888;1431;637;1;0;24957
2022-07-22 08:30;24015;1463;632;4;0;26114
2022-07-22 09:30;24551;1479;629;6;0;26665
2022-07-22 10:30;24865;1433;627;8;0;26933
2022-07-22 11:30;25069;1379;625;9;0;27082
2022-07-22 12:30;25157;1283;598;9;0;27047
2022-07-22 13:30;25107;1288;595;8;0;26998
2022-07-22 14:30;24752;1466;598;9;0;26825
2022-07-22 15:30;24517;1628;598;8;0;26751
2022-07-22 16:30;24677;1344;595;7;0;26623
2022-07-22 17:30;25322;1178;598;5;0;27103
2022-07-22 18:30;25219;1010;599;2;0;26830
2022-07-22 19:30;24659;791;602;0;0;26052
2022-07-22 20:30;24417;850;602;0;0;25869
2022-07-22 21:30;23645;1128;609;0;0;25382
2022-07-22 22:30;22634;1252;615;0;0;24501
2022-07-22 23:30;21600;1129;610;0;0;23339
2022-07-23 00:30;20786;1159;611;0;0;22556
2022-07-23 01:30;19478;1113;610;0;0;21201
2022-07-23 02:30;18503;1125;610;0;0;20238
2022-07-23 03:30;18032;959;610;0;0;19601
2022-07-23 04:30;18038;953;610;0;0;19601
2022-07-23 05:30;18261;827;609;0;0;19697
2022-07-23 06:30;19268;798;609;0;0;20675
2022-07-23 07:30;19869;702;606;1;0;21178
2022-07-23 08:30;21672;628;598;3;0;22901
2022-07-23 09:30;23437;694;599;4;0;24734
2022-07-23 10:30;23967;1085;590;8;0;25650
2022-07-23 11:30;24069;1351;592;9;0;26021
2022-07-23 12:30;23954;1670;622;9;0;26255
2022-07-23 13:30;23570;1988;625;9;0;26192
2022-07-23 14:30;23182;1862;630;9;0;25683
2022-07-23 15:30;23344;1641;630;8;0;25623
2022-07-23 16:30;23727;1784;629;7;0;26147
2022-07-23 17:30;23120;1638;628;5;0;25391
2022-07-23 18:30;22511;1489;629;1;0;24630
2022-07-23 19:30;22732;1366;628;1;0;24727
2022-07-23 20:30;22392;1653;626;0;0;24671
2022-07-23 21:30;22301;1548;636;0;0;24485
2022-07-23 22:30;21683;1549;639;0;0;23871
2022-07-23 23:30;21086;1554;636;0;0;23276
2022-07-24 00:30;19979;1566;638;0;0;22183
2022-07-24 01:30;19360;1548;633;0;0;21541
2022-07-24 02:30;18334;1454;635;0;0;20423
2022-07-24 03:30;17884;1124;634;0;0;19642
2022-07-24 04:30;17781;944;629;0;0;19354
2022-07-24 05:30;18064;670;630;0;0;19364
2022-07-24 06:30;18343;565;628;0;0;19536
2022-07-24 07:30;19772;452;624;1;0;20849
2022-07-24 08:30;21427;358;621;1;0;22407
2022-07-24 09:30;23137;426;620;4;0;24187
2022-07-24 10:30;24127;359;621;5;0;25112
2022-07-24 11:30;24548;445;623;7;0;25623
2022-07-24 12:30;24667;559;655;6;0;25887
2022-07-24 13:30;24843;589;658;8;0;26098
2022-07-24 14:30;24598;607;661;2;0;25868
2022-07-24 15:30;24447;608;663;1;0;25719
2022-07-24 16:30;24830;548;664;3;0;26045
2022-07-24 17:30;24698;856;665;1;0;26220
2022-07-24 18:30;24715;917;664;0;0;26296
2022-07-24 19:30;23729;1077;665;1;0;25472
2022-07-24 20:30;23105;1092;665;0;0;24862
2022-07-24 21:30;23058;1143;670;0;0;24871
2022-07-24 22:30;22340;1082;674;0;0;24096
2022-07-24 23:30;21160;1428;668;0;0;23256
2022-07-25 00:30;19824;1333;665;0;0;21822
2022-07-25 01:30;19293;950;666;0;0;20909
2022-07-25 02:30;19005;790;666;0;0;20461
2022-07-25 03:30;19418;945;665;0;0;21028
2022-07-25 04:30;18788;950;660;0;0;20398
2022-07-25 05:30;19563;1051;664;0;0;21278
2022-07-25 06:30;20496;1139;662;0;0;22297
2022-07-25 07:30;21428;1223;659;0;0;23310
2022-07-25 08:30;22201;1182;653;0;0;24036
2022-07-25 09:30;23157;988;652;3;0;24800
2022-07-25 10:30;23785;1195;649;7;0;25636
2022-07-25 11:30;24104;1311;651;8;0;26074
2022-07-25 12:30;23925;1486;647;6;0;26064
2022-07-25 13:30;23742;1504;645;5;0;25896
2022-07-25 14:30;23121;1761;650;7;0;25539
2022-07-25 15:30;22627;1951;651;9;0;25238
2022-07-25 16:30;22397;1959;652;8;0;25016
2022-07-25 17:30;22869;2519;656;5;0;26049
2022-07-25 18:30;22779;2300;657;2;0;25738
2022-07-25 19:30;22591;2079;658;0;0;25328
2022-07-25 20:30;22005;2218;659;0;0;24882
2022-07-25 21:30;21768;2178;666;0;0;24612
2022-07-25 22:30;20617;2206;671;0;0;23494
2022-07-25 23:30;19377;2327;665;0;0;22369
2022-07-26 00:30;18021;2363;667;0;0;21051
2022-07-26 01:30;17064;2445;663;0;0;20172
2022-07-26 02:30;16358;2474;664;0;0;19496
2022-07-26 03:30;16309;2348;664;0;0;19321
2022-07-26 04:30;16498;2164;665;0;0;19327
2022-07-26 05:30;17499;1952;666;0;0;20117
2022-07-26 06:30;19341;1807;664;0;0;21812
2022-07-26 07:30;21121;1567;658;1;0;23347
2022-07-26 08:30;21883;1408;656;4;0;23951
2022-07-26 09:30;22669;1501;663;6;0;24839
2022-07-26 10:30;23161;1496;661;8;0;25326
2022-07-26 11:30;23240;1546;666;9;0;25461
2022-07-26 12:30;23095;1750;668;9;0;25522
2022-07-26 13:30;22665;1981;653;9;0;25308
2022-07-26 14:30;22653;1952;655;9;0;25269
2022-07-26 15:30;22387;1818;657;4;0;24866
2022-07-26 16:30;22892;1702;657;3;0;25254
2022-07-26 17:30;23595;1484;657;3;0;25739
2022-07-26 18:30;23640;1332;662;3;0;25637
2022-07-26 19:30;23255;1582;660;0;0;25497
2022-07-26 20:30;22956;1774;656;0;0;25386
2022-07-26 21:30;22667;1833;658;0;0;25158
2022-07-26 22:30;21639;1766;664;0;0;24069
2022-07-26 23:30;20480;1563;663;0;0;22706
2022-07-27 00:30;19805;1658;666;0;0;22129
2022-07-27 01:30;18765;1533;662;0;0;20960
2022-07-27 02:30;17680;1719;661;0;0;20060
2022-07-27 03:30;17352;1750;658;0;0;19760
2022-07-27 04:30;17342;1742;662;0;0;19746
2022-07-27 05:30;18293;1597;663;0;0;20553
2022-07-27 06:30;19720;1481;663;0;0;21864
2022-07-27 07:30;21854;1215;653;2;0;23724
2022-07-27 08:30;22904;1144;651;2;0;24701
2022-07-27 09:30;23542;1077;645;6;0;25270
2022-07-27 10:30;24091;937;645;8;0;25681
2022-07-27 11:30;24386;713;647;9;0;25755
2022-07-27 12:30;24798;574;649;9;0;26030
2022-07-27 13:30;24935;588;643;9;0;26175
2022-07-27 14:30;24708;621;640;8;0;25977
2022-07-27 15:30;24598;616;639;7;0;25860
2022-07-27 16:30;24795;573;639;5;0;26012
2022-07-27 17:30;25459;491;641;4;0;26595
2022-07-27 18:30;25018;370;644;2;0;26034
2022-07-27 19:30;24950;326;648;0;0;25924
2022-07-27 20:30;24585;389;649;0;0;25623
2022-07-27 21:30;24640;365;650;0;0;25655
2022-07-27 22:30;23548;434;654;0;0;24636
2022-07-27 23:30;22346;412;659;0;0;23417
2022-07-28 00:30;21337;392;659;0;0;22388
2022-07-28 01:30;19926;342;653;0;0;20921
2022-07-28 02:30;19683;219;653;0;0;20555
2022-07-28 03:30;19497;160;656;0;0;20313
2022-07-28 04:30;19178;133;656;0;0;19967
2022-07-28 05:30;20196;112;657;0;0;20965
2022-07-28 06:30;21690;112;655;0;0;22457
2022-07-28 07:30;23558;144;649;1;0;24352
2022-07-28 08:30;24567;96;650;2;0;25315
2022-07-28 09:30;25100;87;644;5;0;25836
2022-07-28 10:30;25372;104;643;7;0;26126
2022-07-28 11:30;25705;117;646;8;0;26476
2022-07-28 12:30;25620;160;655;7;0;26442
2022-07-28 13:30;25944;224;659;8;0;26835
2022-07-28 14:30;25612;297;663;3;0;26575
2022-07-28 15:30;24944;387;663;0;0;25994
2022-07-28 16:30;23416;583;667;0;0;24666
2022-07-28 17:30;24327;585;665;2;0;25579
2022-07-28 18:30;24041;786;666;1;0;25494
2022-07-28 19:30;23566;1053;666;0;0;25285
2022-07-28 20:30;23081;1300;663;0;0;25044
2022-07-28 21:30;23275;1478;666;0;0;25419
2022-07-28 22:30;21893;1802;668;0;0;24363
2022-07-28 23:30;20706;1854;665;0;0;23225
2022-07-29 00:30;19497;2007;668;0;0;22172
2022-07-29 01:30;18530;1753;669;0;0;20952
2022-07-29 02:30;17922;1862;668;0;0;20452
2022-07-29 03:30;17315;1733;667;0;0;19715
2022-07-29 04:30;17740;1475;665;0;0;19880
2022-07-29 05:30;17935;1557;667;0;0;20159
2022-07-29 06:30;18999;1508;667;0;0;21174
2022-07-29 07:30;21010;1267;668;1;0;22946
2022-07-29 08:30;22083;1263;659;4;0;24009
2022-07-29 09:30;22560;1362;656;6;0;24584
2022-07-29 10:30;22991;1523;653;8;0;25175
2022-07-29 11:30;23180;1610;659;9;0;25458
2022-07-29 12:30;23188;1739;636;5;0;25568
2022-07-29 13:30;22964;1759;639;5;0;25367
2022-07-29 14:30;22905;1768;636;4;0;25313
2022-07-29 15:30;22460;1926;632;3;0;25021
2022-07-29 16:30;22797;1825;631;6;0;25259
2022-07-29 17:30;22203;1675;635;5;0;24518
2022-07-29 18:30;22667;1629;636;2;0;24934
2022-07-29 19:30;22826;1449;640;0;0;24915
2022-07-29 20:30;22598;1354;640;0;0;24592
2022-07-29 21:30;22202;1595;644;0;0;24441
2022-07-29 22:30;21226;1812;648;0;0;23686
2022-07-29 23:30;19804;1828;642;0;0;22274
2022-07-30 00:30;18635;1860;648;0;0;21143
2022-07-30 01:30;17905;1675;646;0;0;20226
2022-07-30 02:30;16785;1548;646;0;0;18979
2022-07-30 03:30;16193;1419;646;0;0;18258
2022-07-30 04:30;16084;1297;647;0;0;18028
2022-07-30 05:30;16195;1131;647;0;0;17973
2022-07-30 06:30;16857;1118;650;0;0;18625
2022-07-30 07:30;18628;813;647;1;0;20089
2022-07-30 08:30;20071;812;641;4;0;21528
2022-07-30 09:30;20920;918;636;6;0;22480
2022-07-30 10:30;21015;919;638;5;0;22577
2022-07-30 11:30;21688;1127;641;3;0;23459
2022-07-30 12:30;20960;1611;606;2;0;23179
2022-07-30 13:30;19974;1788;606;5;0;22373
2022-07-30 14:30;19909;2011;608;6;0;22534
2022-07-30 15:30;20101;1968;606;1;0;22676
2022-07-30 16:30;20233;1872;602;2;0;22709
2022-07-30 17:30;20506;1927;605;2;0;23040
2022-07-30 18:30;20468;2001;606;1;0;23076
2022-07-30 19:30;20207;2108;608;1;0;22924
2022-07-30 20:30;19602;2374;608;0;0;22584
2022-07-30 21:30;19862;2438;612;0;0;22912
2022-07-30 22:30;19159;2604;615;0;0;22378
2022-07-30 23:30;18224;2609;614;0;0;21447
2022-07-31 00:30;17400;2614;610;0;0;20624
2022-07-31 01:30;16695;2507;611;0;0;19813
2022-07-31 02:30;15997;2405;614;0;0;19016
2022-07-31 03:30;15295;2193;610;0;0;18098
2022-07-31 04:30;14794;2200;612;0;0;17606
2022-07-31 05:30;14655;2166;611;0;0;17432
2022-07-31 06:30;15129;2002;610;0;0;17741
2022-07-31 07:30;16800;1671;608;1;0;19080
2022-07-31 08:30;19049;1593;602;4;0;21248
2022-07-31 09:30;21151;1494;603;6;0;23254
2022-07-31 10:30;21592;1644;602;8;0;23846
2022-07-31 11:30;21818;1525;605;9;0;23957
2022-07-31 12:30;22138;1474;607;9;0;24228
2022-07-31 13:30;22074;1441;615;9;0;24139
2022-07-31 14:30;21828;1430;612;9;0;23879
2022-07-31 15:30;21920;1303;621;9;0;23853
2022-07-31 16:30;22468;1408;624;5;0;24505
2022-07-31 17:30;22955;1302;625;4;0;24886
2022-07-31 18:30;23337;1183;626;1;0;25147
2022-07-31 19:30;23200;1047;624;1;0;24872
2022-07-31 20:30;22872;1300;625;0;0;24797
2022-07-31 21:30;22515;1549;629;0;0;24693
2022-07-31 22:30;21428;1721;631;0;0;23780
2022-07-31 23:30;20230;1615;627;0;0;22472
2022-08-01 00:30;19565;1437;624;0;0;21626
2022-08-01 01:30;18568;1384;620;0;0;20572
2022-08-01 02:30;18091;1294;619;0;0;20004
2022-08-01 03:30;17170;1043;610;0;0;18823
2022-08-01 04:30;16736;917;609;0;0;18262
2022-08-01 05:30;17199;769;608;0;0;18576
2022-08-01 06:30;18947;529;610;0;0;20086
2022-08-01 07:30;20890;361;608;1;0;21860
2022-08-01 08:30;23025;198;602;1;0;23826
2022-08-01 09:30;23179;202;597;1;0;23979
2022-08-01 10:30;24139;217;594;8;0;24958
2022-08-01 11:30;25059;287;599;9;0;25954
2022-08-01 12:30;24551;336;617;6;0;25510
2022-08-01 13:30;24680;430;617;3;0;25730
2022-08-01 14:30;24404;438;619;4;0;25465
2022-08-01 15:30;24270;464;619;7;0;25360
2022-08-01 16:30;25408;508;620;2;0;26538
2022-08-01 17:30;25931;478;620;5;0;27034
2022-08-01 18:30;25643;466;622;1;0;26732
2022-08-01 19:30;25177;546;622;1;0;26346
2022-08-01 20:30;24541;844;619;0;0;26004
2022-08-01 21:30;23600;1061;620;0;0;25281
2022-08-01 22:30;22230;1318;624;0;0;24172
2022-08-01 23:30;20960;1368;621;0;0;22949
2022-08-02 00:30;19547;1521;618;0;0;21686
2022-08-02 01:30;18740;1526;619;0;0;20885
2022-08-02 02:30;18141;1539;617;0;0;20297
2022-08-02 03:30;17432;1587;617;0;0;19636
2022-08-02 04:30;17046;1650;615;0;0;19311
2022-08-02 05:30;18383;1752;616;0;0;20751
2022-08-02 06:30;19808;1623;616;0;0;22047
2022-08-02 07:30;21279;1587;614;0;0;23480
2022-08-02 08:30;22450;1393;606;0;0;24449
2022-08-02 09:30;23018;1277;603;1;0;24899
2022-08-02 10:30;23038;1308;598;5;0;24949
2022-08-02 11:30;23932;1174;603;3;0;25712
2022-08-02 12:30;23853;1160;590;7;0;25610
2022-08-02 13:30;23766;1096;592;8;0;25462
2022-08-02 14:30;23544;1167;591;4;0;25306
2022-08-02 15:30;23521;1124;594;5;0;25244
2022-08-02 16:30;23937;1172;596;7;0;25712
2022-08-02 17:30;24756;1013;593;6;0;26368
2022-08-02 18:30;24278;1056;599;2;0;25935
2022-08-02 19:30;23562;1175;599;0;0;25336
2022-08-02 20:30;22844;1346;603;0;0;24793
2022-08-02 21:30;22684;1211;606;0;0;24501
2022-08-02 22:30;20865;1421;610;0;0;22896
2022-08-02 23:30;20054;1467;608;0;0;22129
2022-08-03 00:30;18883;1344;608;0;0;20835
2022-08-03 01:30;18626;1151;605;0;0;20382
2022-08-03 02:30;18266;1016;605;0;0;19887
2022-08-03 03:30;17518;893;604;0;0;19015
2022-08-03 04:30;17273;914;606;0;0;18793
2022-08-03 05:30;17888;810;608;0;0;19306
2022-08-03 06:30;19641;505;606;0;0;20752
2022-08-03 07:30;21008;270;600;1;0;21879
2022-08-03 08:30;22601;253;597;4;6;23461
2022-08-03 09:30;23491;265;596;7;0;24359
2022-08-03 10:30;23665;264;596;7;0;24532
2022-08-03 11:30;23765;167;599;8;0;24539
2022-08-03 12:30;23819;71;599;9;0;24498
2022-08-03 13:30;23303;68;581;8;0;23960
2022-08-03 14:30;23198;103;581;8;0;23890
2022-08-03 15:30;23627;137;580;8;0;24352
2022-08-03 16:30;23685;190;583;7;0;24465
2022-08-03 17:30;24570;297;578;4;0;25449
2022-08-03 18:30;24392;385;584;1;0;25362
2022-08-03 19:30;24114;585;585;0;0;25284
2022-08-03 20:30;23635;1000;586;0;0;25221
2022-08-03 21:30;22348;1543;591;0;0;24482
2022-08-03 22:30;20879;1854;598;0;0;23331
2022-08-03 23:30;20187;2085;595;0;0;22867
2022-08-04 00:30;19222;2186;594;0;0;22002
2022-08-04 01:30;18489;2024;593;0;0;21106
2022-08-04 02:30;17699;1839;589;0;0;20127
2022-08-04 03:30;17231;1720;590;0;0;19541
2022-08-04 04:30;17506;1649;590;0;0;19745
2022-08-04 05:30;18728;1530;591;0;0;20849
2022-08-04 06:30;20043;1481;589;0;0;22113
2022-08-04 07:30;21258;1615;586;0;0;23459
2022-08-04 08:30;22247;1526;585;0;0;24358
2022-08-04 09:30;22995;1439;585;4;0;25023
2022-08-04 10:30;23168;1444;584;2;0;25198
2022-08-04 11:30;23456;1252;588;3;0;25299
2022-08-04 12:30;23807;1282;575;3;0;25667
2022-08-04 13:30;23631;1241;576;2;0;25450
2022-08-04 14:30;23785;1136;573;2;0;25496
2022-08-04 15:30;23789;987;574;2;0;25352
2022-08-04 16:30;24111;918;573;2;0;25604
2022-08-04 17:30;24689;745;574;1;0;26009
2022-08-04 18:30;24557;661;575;1;0;25794
2022-08-04 19:30;24820;646;575;1;0;26042
2022-08-04 20:30;24627;753;581;0;0;25961
2022-08-04 21:30;24046;764;585;0;0;25395
2022-08-04 22:30;23109;974;585;0;0;24668
2022-08-04 23:30;22185;877;582;0;0;23644
2022-08-05 00:30;21270;965;583;0;0;22818
2022-08-05 01:30;20956;946;582;0;0;22484
2022-08-05 02:30;20573;810;582;0;0;21965
2022-08-05 03:30;19877;632;582;0;0;21091
2022-08-05 04:30;18617;727;581;0;0;19925
2022-08-05 05:30;19619;684;580;0;0;20883
2022-08-05 06:30;20584;606;579;0;0;21769
2022-08-05 07:30;22196;580;574;1;0;23351
2022-08-05 08:30;23701;556;570;2;0;24829
2022-08-05 09:30;23865;563;567;5;0;25000
2022-08-05 10:30;24456;611;567;6;0;25640
2022-08-05 11:30;24801;547;571;9;0;25928
2022-08-05 12:30;25003;532;574;9;0;26118
2022-08-05 13:30;24900;597;596;9;0;26102
2022-08-05 14:30;24701;665;597;9;0;25972
2022-08-05 15:30;24829;665;597;9;0;26100
2022-08-05 16:30;25175;616;597;7;0;26395
2022-08-05 17:30;25274;528;599;5;0;26406
2022-08-05 18:30;25264;382;599;2;0;26247
2022-08-05 19:30;24870;270;602;0;0;25742
2022-08-05 20:30;24397;237;601;0;0;25235
2022-08-05 21:30;24136;299;605;0;0;25040
2022-08-05 22:30;23207;235;608;0;0;24050
2022-08-05 23:30;22374;222;607;0;0;23203
2022-08-06 00:30;21725;257;607;0;0;22589
2022-08-06 01:30;21128;204;604;0;0;21936
2022-08-06 02:30;21086;170;602;0;0;21858
2022-08-06 03:30;20588;191;602;0;0;21381
2022-08-06 04:30;20381;120;601;0;0;21102
2022-08-06 05:30;20161;109;601;0;0;20871
2022-08-06 06:30;21027;271;601;0;0;21899
2022-08-06 07:30;21316;340;599;1;0;22256
2022-08-06 08:30;23233;271;588;4;0;24096
2022-08-06 09:30;23975;397;586;6;0;24964
2022-08-06 10:30;24325;519;578;8;0;25430
2022-08-06 11:30;24449;440;585;9;0;25483
2022-08-06 12:30;24881;475;586;9;0;25951
2022-08-06 13:30;24785;657;581;9;0;26032
2022-08-06 14:30;24540;884;591;9;0;26024
2022-08-06 15:30;24298;1136;594;7;0;26035
2022-08-06 16:30;24333;1378;594;3;0;26308
2022-08-06 17:30;23989;1617;595;3;0;26204
2022-08-06 18:30;23968;1571;595;2;0;26136
2022-08-06 19:30;23134;1851;599;0;0;25584
2022-08-06 20:30;22606;2100;597;0;0;25303
2022-08-06 21:30;22235;2214;598;0;0;25047
2022-08-06 22:30;21202;2475;599;0;0;24276
2022-08-06 23:30;20708;2645;604;0;0;23957
2022-08-07 00:30;19865;2706;602;0;0;23173
2022-08-07 01:30;19413;2309;599;0;0;22321
2022-08-07 02:30;18780;2344;600;0;0;21724
2022-08-07 03:30;18616;2691;599;0;0;21906
2022-08-07 04:30;18530;2682;599;0;0;21811
2022-08-07 05:30;18602;2627;599;0;0;21828
2022-08-07 06:30;19342;2507;594;0;0;22443
2022-08-07 07:30;20491;2336;591;1;0;23419
2022-08-07 08:30;21514;2308;589;2;0;24413
2022-08-07 09:30;22730;2034;587;6;0;25357
2022-08-07 10:30;23506;2092;582;8;0;26188
2022-08-07 11:30;24358;1809;582;9;0;26758
2022-08-07 12:30;24155;1689;583;4;0;26431
2022-08-07 13:30;24192;2187;583;9;0;26971
2022-08-07 14:30;22963;2327;583;5;0;25878
2022-08-07 15:30;22940;1843;587;4;0;25374
2022-08-07 16:30;23176;1914;589;2;0;25681
2022-08-07 17:30;23965;1480;593;1;0;26039
2022-08-07 18:30;23746;1549;595;0;0;25890
2022-08-07 19:30;23543;1549;596;0;0;25688
2022-08-07 20:30;23326;1600;595;0;0;25521
2022-08-07 21:30;22786;1459;596;0;0;24841
2022-08-07 22:30;21819;1456;600;0;0;23875
2022-08-07 23:30;21042;1379;598;0;0;23019
2022-08-08 00:30;20408;1302;594;0;0;22304
2022-08-08 01:30;19938;1332;593;0;0;21863
2022-08-08 02:30;19892;1319;591;0;0;21802
2022-08-08 03:30;19719;1154;591;0;0;21464
2022-08-08 04:30;19805;1106;589;0;0;21500
2022-08-08 05:30;20213;1064;588;0;0;21865
2022-08-08 06:30;21279;1041;586;0;0;22906
2022-08-08 07:30;22499;920;581;0;0;24000
2022-08-08 08:30;23162;724;580;1;0;24467
2022-08-08 09:30;23247;717;577;0;0;24541
2022-08-08 10:30;23633;527;578;1;0;24739
2022-08-08 11:30;23718;548;584;2;0;24852
2022-08-08 12:30;23896;521;590;2;0;25009
2022-08-08 13:30;23452;453;588;1;0;24494
2022-08-08 14:30;23165;486;587;1;0;24239
2022-08-08 15:30;23075;388;583;2;0;24048
2022-08-08 16:30;23029;439;586;2;0;24056
2022-08-08 17:30;23379;488;584;1;0;24452
2022-08-08 18:30;23236;618;583;0;0;24437
2022-08-08 19:30;23274;696;585;0;0;24555
2022-08-08 20:30;23262;948;586;0;0;24796
2022-08-08 21:30;22650;1058;584;0;0;24292
2022-08-08 22:30;21957;1018;589;0;0;23564
2022-08-08 23:30;20743;1125;590;0;0;22458
2022-08-09 00:30;20144;1231;591;0;0;21966
2022-08-09 01:30;18957;1326;587;0;0;20870
2022-08-09 02:30;18234;1130;589;0;0;19953
2022-08-09 03:30;18135;917;588;0;0;19640
2022-08-09 04:30;18017;959;585;0;0;19561
2022-08-09 05:30;18532;916;585;0;0;20033
2022-08-09 06:30;19993;854;583;0;0;21430
2022-08-09 07:30;21977;704;583;0;0;23264
2022-08-09 08:30;22691;610;582;1;0;23884
2022-08-09 09:30;23017;578;578;1;0;24174
2022-08-09 10:30;23262;506;578;2;0;24348
2022-08-09 11:30;23463;479;582;3;0;24527
2022-08-09 12:30;23384;494;584;2;0;24464
2022-08-09 13:30;22692;502;585;1;0;23780
2022-08-09 14:30;22791;392;589;1;0;23773
2022-08-09 15:30;22966;258;590;1;0;23815
2022-08-09 16:30;22908;227;592;1;0;23728
2022-08-09 17:30;23645;192;593;1;0;24431
2022-08-09 18:30;23319;124;597;0;0;24040
2022-08-09 19:30;22972;114;604;0;0;23690
2022-08-09 20:30;23171;182;605;0;0;23958
2022-08-09 21:30;22703;257;608;0;0;23568
2022-08-09 22:30;22117;289;609;0;0;23015
2022-08-09 23:30;21112;256;609;0;0;21977
2022-08-10 00:30;20500;198;608;0;0;21306
2022-08-10 01:30;19848;148;607;0;0;20603
2022-08-10 02:30;18902;126;604;0;0;19632
2022-08-10 03:30;18608;116;607;0;0;19331
2022-08-10 04:30;18623;111;610;0;0;19344
2022-08-10 05:30;19640;128;605;0;0;20373
2022-08-10 06:30;20447;120;606;0;0;21173
2022-08-10 07:30;22344;52;598;0;0;22994
2022-08-10 08:30;23330;21;597;1;0;23949
2022-08-10 09:30;23631;56;598;5;0;24290
2022-08-10 10:30;23745;86;596;7;0;24434
2022-08-10 11:30;23906;89;596;4;0;24595
2022-08-10 12:30;23932;144;601;8;0;24685
2022-08-10 13:30;23812;148;600;8;0;24568
2022-08-10 14:30;23620;208;601;4;0;24433
2022-08-10 15:30;23842;266;599;6;0;24713
2022-08-10 16:30;23662;295;599;7;0;24563
2022-08-10 17:30;23883;295;597;5;0;24780
2022-08-10 18:30;24241;350;598;2;0;25191
2022-08-10 19:30;23984;550;601;0;0;25135
2022-08-10 20:30;23689;806;598;0;0;25093
2022-08-10 21:30;22957;1132;599;0;0;24688
2022-08-10 22:30;21907;1334;601;0;0;23842
2022-08-10 23:30;20505;1535;602;0;0;22642
2022-08-11 00:30;19395;1472;603;0;0;21470
2022-08-11 01:30;18648;1362;601;0;0;20611
2022-08-11 02:30;18414;1306;601;0;0;20321
2022-08-11 03:30;17802;1227;601;0;0;19630
2022-08-11 04:30;17283;1276;605;0;0;19164
2022-08-11 05:30;17937;1217;604;0;0;19758
2022-08-11 06:30;19553;1089;605;0;0;21247
2022-08-11 07:30;21395;881;603;1;0;22880
2022-08-11 08:30;22205;635;600;2;0;23442
2022-08-11 09:30;24079;416;601;6;0;25102
2022-08-11 10:30;24339;323;603;4;0;25269
2022-08-11 11:30;24961;210;605;5;0;25781
2022-08-11 12:30;24985;186;603;8;0;25782
2022-08-11 13:30;24928;253;606;9;0;25796
2022-08-11 14:30;24381;376;603;5;0;25365
2022-08-11 15:30;24164;407;606;2;0;25179
2022-08-11 16:30;24490;404;601;5;0;25500
2022-08-11 17:30;24240;329;601;4;0;25174
2022-08-11 18:30;24322;459;603;0;0;25384
2022-08-11 19:30;24182;321;603;0;0;25106
2022-08-11 20:30;23770;465;601;0;0;24836
2022-08-11 21:30;22902;605;604;0;0;24111
2022-08-11 22:30;20933;639;601;0;0;22173
2022-08-11 23:30;19549;671;604;0;0;20824
2022-08-12 00:30;18524;521;604;0;0;19649
2022-08-12 01:30;17784;460;606;0;0;18850
2022-08-12 02:30;16561;514;604;0;0;17679
2022-08-12 03:30;16494;461;605;0;0;17560
2022-08-12 04:30;16708;420;603;0;0;17731
2022-08-12 05:30;18156;453;604;0;0;19213
2022-08-12 06:30;20124;383;603;0;0;21110
2022-08-12 07:30;22025;299;602;1;0;22927
2022-08-12 08:30;22635;277;597;2;0;23511
2022-08-12 09:30;23067;254;598;2;0;23921
2022-08-12 10:30;23766;205;596;5;0;24572
2022-08-12 11:30;23396;202;598;2;0;24198
2022-08-12 12:30;23607;257;597;5;0;24466
2022-08-12 13:30;23646;261;609;5;0;24521
2022-08-12 14:30;23412;227;610;3;0;24252
2022-08-12 15:30;23306;242;608;4;0;24160
2022-08-12 16:30;23318;222;609;1;0;24150
2022-08-12 17:30;23647;223;609;1;0;24480
2022-08-12 18:30;23347;211;608;1;0;24167
2022-08-12 19:30;23266;258;609;0;0;24133
2022-08-12 20:30;23218;433;609;0;0;24260
2022-08-12 21:30;22947;516;613;0;0;24076
2022-08-12 22:30;21850;487;613;0;0;22950
2022-08-12 23:30;20907;428;612;0;0;21947
2022-08-13 00:30;19707;389;612;0;0;20708
2022-08-13 01:30;18309;309;611;0;0;19229
2022-08-13 02:30;17588;241;611;0;0;18440
2022-08-13 03:30;17554;172;609;0;0;18335
2022-08-13 04:30;17091;119;607;0;0;17817
2022-08-13 05:30;17217;106;606;0;0;17929
2022-08-13 06:30;17802;90;605;0;0;18497
2022-08-13 07:30;19185;41;603;0;0;19829
2022-08-13 08:30;20502;0;596;4;0;21102
2022-08-13 09:30;22209;6;592;6;0;22813
2022-08-13 10:30;22362;22;589;8;0;22981
2022-08-13 11:30;22503;52;590;9;0;23154
2022-08-13 12:30;22572;49;594;9;0;23224
2022-08-13 13:30;22562;46;599;9;0;23216
2022-08-13 14:30;22822;46;598;9;0;23475
2022-08-13 15:30;22691;46;603;2;0;23342
2022-08-13 16:30;23644;23;607;2;0;24276
2022-08-13 17:30;23743;47;606;2;0;24398
2022-08-13 18:30;23775;46;609;1;0;24431
2022-08-13 19:30;23230;110;610;0;0;23950
2022-08-13 20:30;23127;159;609;0;0;23895
2022-08-13 21:30;22554;106;613;0;0;23273
2022-08-13 22:30;21563;115;612;0;0;22290
2022-08-13 23:30;21155;128;611;0;0;21894
2022-08-14 00:30;19611;104;610;0;0;20325
2022-08-14 01:30;18369;127;611;0;0;19107
2022-08-14 02:30;17607;170;608;0;0;18385
2022-08-14 03:30;17011;180;607;0;0;17798
2022-08-14 04:30;16912;184;606;0;0;17702
2022-08-14 05:30;17063;214;608;0;0;17885
2022-08-14 06:30;17299;249;607;0;0;18155
2022-08-14 07:30;18207;240;605;1;0;19053
2022-08-14 08:30;20035;167;599;4;0;20805
2022-08-14 09:30;21438;96;596;6;0;22136
2022-08-14 10:30;21880;61;598;8;0;22547
2022-08-14 11:30;22286;37;599;9;0;22931
2022-08-14 12:30;22697;70;598;9;0;23374
2022-08-14 13:30;22640;59;603;9;0;23311
2022-08-14 14:30;22661;84;605;9;0;23359
2022-08-14 15:30;23111;89;603;8;0;23811
2022-08-14 16:30;23637;116;602;7;0;24362
2022-08-14 17:30;24039;98;604;2;0;24743
2022-08-14 18:30;24044;143;604;1;0;24792
2022-08-14 19:30;23666;125;606;0;0;24397
2022-08-14 20:30;23691;221;606;0;0;24518
2022-08-14 21:30;23320;278;610;0;0;24208
2022-08-14 22:30;21998;364;607;0;0;22969
2022-08-14 23:30;20694;452;607;0;0;21753
2022-08-15 00:30;19765;589;605;0;0;20959
2022-08-15 01:30;18561;663;604;0;0;19828
2022-08-15 02:30;17859;736;603;0;0;19198
2022-08-15 03:30;16964;736;602;0;0;18302
2022-08-15 04:30;17202;725;602;0;0;18529
2022-08-15 05:30;18188;630;601;0;0;19419
2022-08-15 06:30;20536;431;602;0;0;21569
2022-08-15 07:30;22670;339;599;0;0;23608
2022-08-15 08:30;23582;189;595;0;0;24366
2022-08-15 09:30;24309;104;591;6;0;25010
2022-08-15 10:30;25147;129;585;8;0;25869
2022-08-15 11:30;25374;148;590;9;0;26121
2022-08-15 12:30;25732;163;550;9;0;26454
2022-08-15 13:30;25576;135;550;9;0;26270
2022-08-15 14:30;25256;134;552;9;0;25951
2022-08-15 15:30;25202;145;552;8;0;25907
2022-08-15 16:30;25389;149;556;7;0;26101
2022-08-15 17:30;25835;170;552;4;0;26561
2022-08-15 18:30;25674;251;557;1;0;26483
2022-08-15 19:30;25184;271;558;0;0;26013
2022-08-15 20:30;25169;416;561;0;0;26146
2022-08-15 21:30;24596;273;564;0;0;25433
2022-08-15 22:30;23680;135;563;0;0;24378
2022-08-15 23:30;22378;117;559;0;0;23054
2022-08-16 00:30;21653;107;559;0;0;22319
2022-08-16 01:30;21058;110;559;0;0;21727
2022-08-16 02:30;19968;181;558;0;0;20707
2022-08-16 03:30;19198;249;556;0;0;20003
2022-08-16 04:30;18925;295;555;0;0;19775
2022-08-16 05:30;20238;328;553;0;0;21119
2022-08-16 06:30;21151;331;548;0;0;22030
2022-08-16 07:30;23427;304;546;1;0;24278
2022-08-16 08:30;24008;176;545;4;0;24733
2022-08-16 09:30;24674;119;540;6;0;25339
2022-08-16 10:30;24802;145;534;8;0;25489
2022-08-16 11:30;25120;208;535;9;0;25872
2022-08-16 12:30;25251;258;538;9;0;26056
2022-08-16 13:30;25316;284;525;9;0;26134
2022-08-16 14:30;25070;361;527;9;0;25967
2022-08-16 15:30;24691;499;534;8;0;25732
2022-08-16 16:30;24658;507;536;6;0;25707
2022-08-16 17:30;25070;487;539;3;0;26099
2022-08-16 18:30;24713;419;547;1;0;25680
2022-08-16 19:30;24482;454;550;0;0;25486
2022-08-16 20:30;24482;651;549;0;0;25682
2022-08-16 21:30;24482;697;558;0;0;25737
2022-08-16 22:30;22263;654;562;0;0;23479
2022-08-16 23:30;21371;602;558;0;0;22531
2022-08-17 00:30;20334;547;554;0;0;21435
2022-08-17 01:30;19870;509;552;0;0;20931
2022-08-17 02:30;19725;483;550;0;0;20758
2022-08-17 03:30;19087;399;550;0;0;20036
2022-08-17 04:30;19007;399;548;0;0;19954
2022-08-17 05:30;19049;503;547;0;0;20099
2022-08-17 06:30;20697;535;547;0;0;21779
2022-08-17 07:30;22177;566;545;1;0;23289
2022-08-17 08:30;23026;438;545;3;25;24037
2022-08-17 09:30;23448;564;547;5;26;24590
2022-08-17 10:30;23485;719;542;7;0;24753
2022-08-17 11:30;23838;901;547;9;0;25295
2022-08-17 12:30;23838;892;597;9;0;25336
2022-08-17 13:30;24015;932;594;8;0;25549
2022-08-17 14:30;23827;1073;593;8;0;25501
2022-08-17 15:30;24065;992;592;5;0;25654
2022-08-17 16:30;23956;1131;595;6;0;25688
2022-08-17 17:30;24644;1103;596;3;0;26346
2022-08-17 18:30;23826;1320;602;1;0;25749
2022-08-17 19:30;23630;1443;601;0;0;25674
2022-08-17 20:30;22850;1609;603;0;0;25062
2022-08-17 21:30;22359;1790;609;0;0;24758
2022-08-17 22:30;21149;1853;612;0;0;23614
2022-08-17 23:30;20204;1838;607;0;0;22649
2022-08-18 00:30;19518;1896;607;0;0;22021
2022-08-18 01:30;18736;1981;606;0;0;21323
2022-08-18 02:30;17851;2153;607;0;0;20611
2022-08-18 03:30;17134;2256;608;0;0;19998
2022-08-18 04:30;17100;2167;607;0;0;19874
2022-08-18 05:30;18041;2258;606;0;0;20905
2022-08-18 06:30;19425;2076;607;0;0;22108
2022-08-18 07:30;21072;1997;608;1;0;23678
2022-08-18 08:30;22234;1802;608;2;0;24646
2022-08-18 09:30;22687;1627;598;2;0;24914
2022-08-18 10:30;23256;1438;601;2;0;25297
2022-08-18 11:30;23961;1237;603;4;0;25805
2022-08-18 12:30;23621;1191;556;4;0;25372
2022-08-18 13:30;23625;1245;555;3;0;25428
2022-08-18 14:30;23240;1309;556;3;0;25108
2022-08-18 15:30;23413;1243;557;3;0;25216
2022-08-18 16:30;24063;925;560;1;0;25549
2022-08-18 17:30;24507;808;557;1;0;25873
2022-08-18 18:30;24257;795;560;1;0;25613
2022-08-18 19:30;24505;581;559;0;0;25645
2022-08-18 20:30;24561;454;562;0;0;25577
2022-08-18 21:30;23845;328;563;0;0;24736
2022-08-18 22:30;23031;303;564;0;0;23898
2022-08-18 23:30;21902;256;561;0;0;22719
2022-08-19 00:30;21372;272;560;0;0;22204
2022-08-19 01:30;20758;253;560;0;0;21571
2022-08-19 02:30;19819;308;558;0;0;20685
2022-08-19 03:30;19149;363;560;0;0;20072
2022-08-19 04:30;19067;456;559;0;0;20082
2022-08-19 05:30;19666;542;556;0;0;20764
2022-08-19 06:30;21104;712;552;0;0;22368
2022-08-19 07:30;22114;731;552;0;0;23397
2022-08-19 08:30;23394;755;550;3;0;24702
2022-08-19 09:30;23679;816;551;5;0;25051
2022-08-19 10:30;24208;832;550;8;0;25598
2022-08-19 11:30;24707;919;552;9;0;26187
2022-08-19 12:30;24617;992;528;9;0;26146
2022-08-19 13:30;24703;1014;528;9;0;26254
2022-08-19 14:30;24377;1111;525;9;0;26022
2022-08-19 15:30;24470;1141;525;8;0;26144
2022-08-19 16:30;24723;1094;525;7;0;26349
2022-08-19 17:30;24830;1078;524;5;0;26437
2022-08-19 18:30;24325;1092;516;1;0;25934
2022-08-19 19:30;23741;1205;515;0;0;25461
2022-08-19 20:30;23556;1288;517;0;0;25361
2022-08-19 21:30;22871;1239;524;0;0;24634
2022-08-19 22:30;21985;1321;528;0;0;23834
2022-08-19 23:30;20963;1301;528;0;0;22792
2022-08-20 00:30;20134;1356;527;0;0;22017
2022-08-20 01:30;19702;1371;524;0;0;21597
2022-08-20 02:30;18982;1379;524;0;0;20885
2022-08-20 03:30;18348;1435;522;0;0;20305
2022-08-20 04:30;18488;1240;520;0;0;20248
2022-08-20 05:30;18530;1124;524;0;0;20178
2022-08-20 06:30;19001;979;520;0;0;20500
2022-08-20 07:30;20471;767;518;1;0;21757
2022-08-20 08:30;22434;401;514;4;0;23353
2022-08-20 09:30;23967;223;515;6;0;24711
2022-08-20 10:30;24525;154;514;8;0;25201
2022-08-20 11:30;24863;194;519;9;0;25585
2022-08-20 12:30;25074;254;542;9;0;25879
2022-08-20 13:30;24828;319;541;9;0;25697
2022-08-20 14:30;24711;312;541;9;0;25573
2022-08-20 15:30;24959;285;540;8;0;25792
2022-08-20 16:30;25150;147;541;7;0;25845
2022-08-20 17:30;24832;160;537;4;0;25533
2022-08-20 18:30;24768;193;538;1;0;25500
2022-08-20 19:30;24262;304;539;0;0;25105
2022-08-20 20:30;23759;382;543;0;0;24684
2022-08-20 21:30;23311;472;547;0;0;24330
2022-08-20 22:30;22787;486;553;0;0;23826
2022-08-20 23:30;22046;569;548;0;0;23163
2022-08-21 00:30;21232;584;548;0;0;22364
2022-08-21 01:30;20118;621;558;0;0;21297
2022-08-21 02:30;20069;558;557;0;0;21184
2022-08-21 03:30;19683;508;558;0;0;20749
2022-08-21 04:30;19466;468;557;0;0;20491
2022-08-21 05:30;19422;463;555;0;0;20440
2022-08-21 06:30;19800;473;554;0;0;20827
2022-08-21 07:30;20540;458;556;1;0;21555
2022-08-21 08:30;22321;336;548;2;0;23207
2022-08-21 09:30;23546;228;546;5;0;24325
2022-08-21 10:30;24417;267;547;8;0;25239
2022-08-21 11:30;24994;460;549;9;0;26012
2022-08-21 12:30;25018;552;586;9;0;26165
2022-08-21 13:30;24856;647;587;5;0;26095
2022-08-21 14:30;24349;815;584;4;0;25752
2022-08-21 15:30;23655;893;585;1;0;25134
2022-08-21 16:30;23773;856;585;0;0;25214
2022-08-21 17:30;24530;653;586;0;0;25769
2022-08-21 18:30;24437;643;589;0;0;25669
2022-08-21 19:30;23575;1062;589;0;0;25226
2022-08-21 20:30;22462;1567;593;0;0;24622
2022-08-21 21:30;22282;1358;596;0;0;24236
2022-08-21 22:30;21590;1527;599;0;0;23716
2022-08-21 23:30;20226;1715;595;0;0;22536
2022-08-22 00:30;18863;1920;590;0;0;21373
2022-08-22 01:30;18903;1529;592;0;0;21024
2022-08-22 02:30;18749;1361;592;0;0;20702
2022-08-22 03:30;18420;1454;591;0;0;20465
2022-08-22 04:30;18629;1299;591;0;0;20519
2022-08-22 05:30;19767;1296;591;0;0;21654
2022-08-22 06:30;20608;1569;590;0;0;22767
2022-08-22 07:30;22256;1511;589;0;0;24356
2022-08-22 08:30;23540;1166;586;3;0;25295
2022-08-22 09:30;24439;719;586;6;0;25750
2022-08-22 10:30;25238;469;582;6;0;26295
2022-08-22 11:30;25885;382;585;6;0;26858
2022-08-22 12:30;25996;311;542;9;0;26858
2022-08-22 13:30;26187;317;544;6;0;27054
2022-08-22 14:30;25851;335;543;5;0;26734
2022-08-22 15:30;25636;330;543;4;0;26513
2022-08-22 16:30;25605;300;539;3;0;26447
2022-08-22 17:30;26152;293;540;1;0;26986
2022-08-22 18:30;25910;381;542;1;0;26834
2022-08-22 19:30;25636;462;542;0;0;26640
2022-08-22 20:30;25472;471;542;0;0;26485
2022-08-22 21:30;24898;495;542;0;0;25935
2022-08-22 22:30;23507;548;545;0;0;24600
2022-08-22 23:30;22025;543;543;0;0;23111
2022-08-23 00:30;21360;441;545;0;0;22346
2022-08-23 01:30;21368;331;544;0;0;22243
2022-08-23 02:30;20826;283;546;0;0;21655
2022-08-23 03:30;20674;213;544;0;0;21431
2022-08-23 04:30;20318;158;544;0;0;21020
2022-08-23 05:30;20760;131;544;0;0;21435
2022-08-23 06:30;22319;114;547;0;0;22980
2022-08-23 07:30;23840;106;543;0;0;24489
2022-08-23 08:30;24453;94;490;0;0;25037
2022-08-23 09:30;24852;88;488;0;0;25428
2022-08-23 10:30;25033;69;486;0;0;25588
2022-08-23 11:30;25378;95;488;0;0;25961
2022-08-23 12:30;25646;102;487;0;0;26235
2022-08-23 13:30;25410;153;484;2;0;26049
2022-08-23 14:30;25065;258;483;6;0;25812
2022-08-23 15:30;24514;293;485;3;0;25295
2022-08-23 16:30;25306;307;485;2;0;26100
2022-08-23 17:30;26141;321;483;2;0;26947
2022-08-23 18:30;25866;357;484;1;0;26708
2022-08-23 19:30;25516;412;489;0;0;26417
2022-08-23 20:30;25184;510;489;0;0;26183
2022-08-23 21:30;24317;514;492;0;0;25323
2022-08-23 22:30;23263;510;497;0;0;24270
2022-08-23 23:30;22400;360;493;0;0;23253
2022-08-24 00:30;21147;196;495;0;0;21838
2022-08-24 01:30;20959;142;492;0;0;21593
2022-08-24 02:30;21239;82;493;0;0;21814
2022-08-24 03:30;20348;75;492;0;0;20915
2022-08-24 04:30;19981;74;492;0;0;20547
2022-08-24 05:30;20978;68;494;0;0;21540
2022-08-24 06:30;22302;60;491;0;0;22853
2022-08-24 07:30;23985;29;491;1;0;24506
2022-08-24 08:30;24822;39;486;2;0;25349
2022-08-24 09:30;25263;21;486;5;0;25775
2022-08-24 10:30;25822;11;486;7;0;26326
2022-08-24 11:30;25900;28;487;6;0;26421
2022-08-24 12:30;25725;61;531;6;0;26323
2022-08-24 13:30;25816;68;533;7;0;26424
2022-08-24 14:30;25426;114;535;7;0;26082
2022-08-24 15:30;25568;132;534;6;0;26240
2022-08-24 16:30;25919;215;537;5;0;26676
2022-08-24 17:30;26015;297;536;2;0;26850
2022-08-24 18:30;25754;349;534;1;0;26638
2022-08-24 19:30;25095;445;535;0;0;26075
2022-08-24 20:30;25323;578;537;0;0;26438
2022-08-24 21:30;24501;615;543;0;0;25659
2022-08-24 22:30;23515;533;545;0;0;24593
2022-08-24 23:30;22110;730;543;0;0;23383
2022-08-25 00:30;21211;857;542;0;0;22610
2022-08-25 01:30;20606;906;539;0;0;22051
2022-08-25 02:30;19721;920;541;0;0;21182
2022-08-25 03:30;19609;915;541;0;0;21065
2022-08-25 04:30;19164;997;540;0;0;20701
2022-08-25 05:30;20140;980;537;0;0;21657
2022-08-25 06:30;21631;960;537;0;0;23128
2022-08-25 07:30;22988;924;533;1;0;24446
2022-08-25 08:30;24057;765;524;3;0;25349
2022-08-25 09:30;24368;707;523;4;0;25602
2022-08-25 10:30;24527;821;524;6;0;25878
2022-08-25 11:30;24684;776;532;7;0;25999
2022-08-25 12:30;24044;652;510;6;0;25212
2022-08-25 13:30;24717;623;509;5;0;25854
2022-08-25 14:30;24375;667;512;0;0;25554
2022-08-25 15:30;24512;619;511;4;0;25646
2022-08-25 16:30;24500;519;512;3;0;25534
2022-08-25 17:30;24830;426;513;1;0;25770
2022-08-25 18:30;24680;422;515;1;0;25618
2022-08-25 19:30;24385;553;516;0;0;25454
2022-08-25 20:30;24354;533;513;0;0;25400
2022-08-25 21:30;23512;537;516;0;0;24565
2022-08-25 22:30;22574;531;524;0;0;23629
2022-08-25 23:30;21351;424;518;0;0;22293
2022-08-26 00:30;20821;315;517;0;0;21653
2022-08-26 01:30;20488;214;516;0;0;21218
2022-08-26 02:30;19863;138;513;0;0;20514
2022-08-26 03:30;19918;69;515;0;0;20502
2022-08-26 04:30;19846;29;517;0;0;20392
2022-08-26 05:30;20666;35;515;0;0;21216
2022-08-26 06:30;21829;103;515;0;0;22447
2022-08-26 07:30;23060;137;514;0;0;23711
2022-08-26 08:30;23734;158;558;1;0;24451
2022-08-26 09:30;24125;235;558;2;0;24920
2022-08-26 10:30;24348;280;559;4;0;25191
2022-08-26 11:30;24504;255;559;3;0;25321
2022-08-26 12:30;24696;173;568;3;0;25440
2022-08-26 13:30;24521;92;569;7;0;25189
2022-08-26 14:30;23930;57;569;3;0;24559
2022-08-26 15:30;22838;61;566;4;0;23469
2022-08-26 16:30;23478;13;567;2;0;24060
2022-08-26 17:30;23803;20;573;2;0;24398
2022-08-26 18:30;24339;33;575;0;0;24947
2022-08-26 19:30;24235;47;578;0;0;24860
2022-08-26 20:30;24072;44;578;0;0;24694
2022-08-26 21:30;23154;51;584;0;0;23789
2022-08-26 22:30;21875;101;583;0;0;22559
2022-08-26 23:30;21125;141;581;0;0;21847
2022-08-27 00:30;20502;156;579;0;0;21237
2022-08-27 01:30;19762;152;574;0;0;20488
2022-08-27 02:30;18972;292;573;0;0;19837
2022-08-27 03:30;18831;376;575;0;0;19782
2022-08-27 04:30;18735;360;575;0;0;19670
2022-08-27 05:30;18799;428;574;0;0;19801
2022-08-27 06:30;19389;478;573;0;0;20440
2022-08-27 07:30;20377;380;570;1;0;21328
2022-08-27 08:30;21682;314;562;1;0;22559
2022-08-27 09:30;21910;289;562;1;0;22762
2022-08-27 10:30;22485;373;564;2;0;23424
2022-08-27 11:30;22435;431;568;5;0;23439
2022-08-27 12:30;22431;403;556;7;0;23397
2022-08-27 13:30;22304;307;560;1;0;23172
2022-08-27 14:30;22429;211;560;6;0;23206
2022-08-27 15:30;22610;182;559;6;0;23357
2022-08-27 16:30;23281;192;560;5;0;24038
2022-08-27 17:30;23199;214;559;3;0;23975
2022-08-27 18:30;23079;215;559;1;0;23854
2022-08-27 19:30;22773;310;559;0;0;23642
2022-08-27 20:30;22937;358;561;0;0;23856
2022-08-27 21:30;22181;390;571;0;0;23142
2022-08-27 22:30;21598;389;574;0;0;22561
2022-08-27 23:30;21056;424;569;0;0;22049
2022-08-28 00:30;19963;529;566;0;0;21058
2022-08-28 01:30;18953;580;565;0;0;20098
2022-08-28 02:30;17828;577;566;0;0;18971
2022-08-28 03:30;17638;594;563;0;0;18795
2022-08-28 04:30;17334;626;566;0;0;18526
2022-08-28 05:30;17141;750;564;0;0;18455
2022-08-28 06:30;17269;895;564;0;0;18728
2022-08-28 07:30;18729;902;559;1;0;20191
2022-08-28 08:30;19892;591;555;3;0;21041
2022-08-28 09:30;21555;460;554;5;0;22574
2022-08-28 10:30;22568;485;550;7;0;23610
2022-08-28 11:30;23168;473;555;8;0;24204
2022-08-28 12:30;23523;404;547;8;0;24482
2022-08-28 13:30;23539;426;551;8;0;24524
2022-08-28 14:30;23420;448;549;8;0;24425
2022-08-28 15:30;23416;520;549;7;0;24492
2022-08-28 16:30;23828;522;549;4;0;24903
2022-08-28 17:30;24159;582;547;3;0;25291
2022-08-28 18:30;24104;692;547;1;0;25344
2022-08-28 19:30;23549;1014;548;0;0;25111
2022-08-28 20:30;23133;1461;549;0;0;25143
2022-08-28 21:30;21927;1663;556;0;0;24146
2022-08-28 22:30;20617;1886;557;0;0;23060
2022-08-28 23:30;19793;1867;552;0;0;22212
2022-08-29 00:30;19113;1889;550;0;0;21552
2022-08-29 01:30;17928;1897;551;0;0;20376
2022-08-29 02:30;16973;1746;550;0;0;19269
2022-08-29 03:30;16474;1554;552;0;0;18580
2022-08-29 04:30;16842;1413;554;0;0;18809
2022-08-29 05:30;18128;1282;552;0;0;19962
2022-08-29 06:30;20405;1114;555;0;0;22074
2022-08-29 07:30;22028;1028;552;1;0;23609
2022-08-29 08:30;23243;800;549;1;0;24593
2022-08-29 09:30;24519;585;549;4;0;25657
2022-08-29 10:30;24937;492;548;7;0;25984
2022-08-29 11:30;25473;565;553;7;0;26598
2022-08-29 12:30;25703;659;546;8;0;26916
2022-08-29 13:30;25888;798;539;8;0;27233
2022-08-29 14:30;25656;991;541;8;0;27196
2022-08-29 15:30;25765;1077;542;4;0;27388
2022-08-29 16:30;26038;1090;541;5;0;27674
2022-08-29 17:30;26648;1032;544;3;154;28381
2022-08-29 18:30;26634;1189;545;1;0;28369
2022-08-29 19:30;25676;1484;546;0;0;27706
2022-08-29 20:30;24793;1867;549;0;0;27209
2022-08-29 21:30;23028;2010;553;0;0;25591
2022-08-29 22:30;22203;2201;553;0;0;24957
2022-08-29 23:30;20860;2265;551;0;0;23676
2022-08-30 00:30;19888;2291;549;0;0;22728
2022-08-30 01:30;19535;2145;551;0;0;22231
2022-08-30 02:30;18952;1921;549;0;0;21422
2022-08-30 03:30;18324;1974;550;0;0;20848
2022-08-30 04:30;18050;1786;549;0;0;20385
2022-08-30 05:30;19656;1529;548;0;0;21733
2022-08-30 06:30;21552;1374;545;0;0;23471
2022-08-30 07:30;23380;1286;539;0;0;25205
2022-08-30 08:30;23648;1031;538;3;0;25220
2022-08-30 09:30;24147;1038;539;5;0;25729
2022-08-30 10:30;24716;963;539;4;0;26222
2022-08-30 11:30;24686;942;542;7;0;26177
2022-08-30 12:30;24535;944;542;5;0;26026
2022-08-30 13:30;25105;1123;556;8;0;26792
2022-08-30 14:30;24785;1252;552;6;0;26595
2022-08-30 15:30;24218;1194;552;3;0;25967
2022-08-30 16:30;24230;1193;552;2;0;25977
2022-08-30 17:30;25460;856;550;1;0;26867
2022-08-30 18:30;25601;783;551;0;0;26935
2022-08-30 19:30;24242;786;557;0;0;25585
2022-08-30 20:30;24234;793;556;0;0;25583
2022-08-30 21:30;23682;1123;555;0;0;25360
2022-08-30 22:30;22318;1314;560;0;0;24192
2022-08-30 23:30;20994;1706;561;0;0;23261
2022-08-31 00:30;19288;2140;561;0;0;21989
2022-08-31 01:30;17729;2385;561;0;0;20675
2022-08-31 02:30;17760;2071;558;0;0;20389
2022-08-31 03:30;16742;2193;560;0;0;19495
2022-08-31 04:30;16813;1734;560;0;0;19107
2022-08-31 05:30;17923;2180;561;0;0;20664
2022-08-31 06:30;19887;2004;555;0;0;22446
2022-08-31 07:30;21513;2045;554;0;0;24112
2022-08-31 08:30;21395;1853;550;1;0;23799
2022-08-31 09:30;21595;1656;550;2;0;23803
2022-08-31 10:30;21899;1636;549;5;0;24089
2022-08-31 11:30;22004;1441;551;4;0;24000
2022-08-31 12:30;22460;1476;553;6;0;24495
2022-08-31 13:30;22931;1282;542;7;0;24762
2022-08-31 14:30;22434;1382;542;3;0;24361
2022-08-31 15:30;22471;1387;542;4;0;24404
2022-08-31 16:30;21789;1760;543;3;0;24095
2022-08-31 17:30;23580;1566;544;2;0;25692
2022-08-31 18:30;22995;1605;540;2;0;25142
2022-08-31 19:30;23398;1654;543;0;0;25595
2022-08-31 20:30;23355;1422;545;0;0;25322
2022-08-31 21:30;21806;1356;543;0;0;23705
2022-08-31 22:30;21047;1375;547;0;0;22969
2022-08-31 23:30;19950;1114;551;0;0;21615
2022-09-01 00:30;18906;1025;548;0;0;20479
2022-09-01 01:30;17798;861;549;0;0;19208
2022-09-01 02:30;17398;883;543;0;0;18824
2022-09-01 03:30;16823;1107;540;0;0;18470
2022-09-01 04:30;17003;1128;536;0;0;18667
2022-09-01 05:30;18501;1071;539;0;0;20111
2022-09-01 06:30;20530;1134;539;0;0;22203
2022-09-01 07:30;22075;1049;539;1;0;23664
2022-09-01 08:30;22169;987;537;3;0;23696
2022-09-01 09:30;22502;1032;538;2;0;24074
2022-09-01 10:30;22242;1029;539;4;0;23814
2022-09-01 11:30;22363;946;539;2;0;23850
2022-09-01 12:30;22343;959;553;4;0;23859
2022-09-01 13:30;22609;1114;550;8;0;24281
2022-09-01 14:30;21964;1284;551;5;0;23804
2022-09-01 15:30;21527;1471;553;2;0;23553
2022-09-01 16:30;22496;1544;554;2;0;24596
2022-09-01 17:30;22791;1575;551;1;0;24918
2022-09-01 18:30;22632;1675;552;0;0;24859
2022-09-01 19:30;22459;1738;554;0;0;24751
2022-09-01 20:30;22712;1853;557;0;0;25122
2022-09-01 21:30;22059;1875;559;0;0;24493
2022-09-01 22:30;20883;1873;563;0;0;23319
2022-09-01 23:30;20047;1810;559;0;0;22416
2022-09-02 00:30;18612;1646;564;0;0;20822
2022-09-02 01:30;18088;1608;554;0;0;20250
2022-09-02 02:30;17444;1622;556;0;0;19622
2022-09-02 03:30;16955;1454;557;0;0;18966
2022-09-02 04:30;16947;1470;557;0;0;18974
2022-09-02 05:30;18175;1521;557;0;0;20253
2022-09-02 06:30;20629;1358;556;0;0;22543
2022-09-02 07:30;22668;1117;555;1;0;24341
2022-09-02 08:30;23167;1060;554;3;0;24784
2022-09-02 09:30;23477;1150;555;5;0;25187
2022-09-02 10:30;23366;1150;556;7;0;25079
2022-09-02 11:30;23593;1186;560;8;0;25347
2022-09-02 12:30;23494;1132;574;8;0;25208
2022-09-02 13:30;23315;1053;576;8;0;24952
2022-09-02 14:30;23524;898;577;8;0;25007
2022-09-02 15:30;23547;776;577;7;0;24907
2022-09-02 16:30;23746;756;580;5;0;25087
2022-09-02 17:30;24326;637;579;3;0;25545
2022-09-02 18:30;24174;626;580;1;0;25381
2022-09-02 19:30;23657;1030;582;0;0;25269
2022-09-02 20:30;22994;1341;581;0;0;24916
2022-09-02 21:30;22203;1628;584;0;0;24415
2022-09-02 22:30;21261;1707;586;0;0;23554
2022-09-02 23:30;20493;1713;584;0;0;22790
2022-09-03 00:30;19200;1710;583;0;0;21493
2022-09-03 01:30;17626;1605;584;0;0;19815
2022-09-03 02:30;18126;1456;581;0;0;20163
2022-09-03 03:30;17409;1402;583;0;0;19394
2022-09-03 04:30;17274;1495;583;0;0;19352
2022-09-03 05:30;17408;1553;587;0;0;19548
2022-09-03 06:30;18179;1434;585;0;0;20198
2022-09-03 07:30;19368;1309;583;1;0;21261
2022-09-03 08:30;20974;1075;576;3;0;22628
2022-09-03 09:30;22240;943;576;5;0;23764
2022-09-03 10:30;22960;812;579;4;0;24355
2022-09-03 11:30;23259;829;580;6;0;24674
2022-09-03 12:30;23501;848;627;6;0;24982
2022-09-03 13:30;23315;847;629;8;0;24799
2022-09-03 14:30;23166;868;627;8;0;24669
2022-09-03 15:30;23085;949;627;7;0;24668
2022-09-03 16:30;23366;952;625;5;0;24948
2022-09-03 17:30;23578;965;627;3;0;25173
2022-09-03 18:30;23351;960;626;1;0;24938
2022-09-03 19:30;22649;1386;628;0;0;24663
2022-09-03 20:30;21957;1722;637;0;0;24316
2022-09-03 21:30;21148;1796;632;0;0;23576
2022-09-03 22:30;20757;1888;638;0;0;23283
2022-09-03 23:30;19973;1744;637;0;0;22354
2022-09-04 00:30;19521;1657;632;0;0;21810
2022-09-04 01:30;19366;1312;636;0;0;21314
2022-09-04 02:30;19148;1099;635;0;0;20882
2022-09-04 03:30;18995;874;637;0;0;20506
2022-09-04 04:30;18950;935;634;0;0;20519
2022-09-04 05:30;18899;822;638;0;0;20359
2022-09-04 06:30;19472;773;633;0;0;20878
2022-09-04 07:30;19812;725;635;0;0;21172
2022-09-04 08:30;21318;628;632;0;0;22578
2022-09-04 09:30;22209;723;628;0;0;23560
2022-09-04 10:30;22225;801;636;1;0;23663
2022-09-04 11:30;22374;837;632;3;0;23846
2022-09-04 12:30;22656;741;636;3;0;24036
2022-09-04 13:30;22371;772;611;5;0;23759
2022-09-04 14:30;22005;878;611;4;0;23498
2022-09-04 15:30;21888;947;612;5;0;23452
2022-09-04 16:30;22227;881;614;5;0;23727
2022-09-04 17:30;22158;831;614;2;0;23605
2022-09-04 18:30;22233;748;615;1;0;23597
2022-09-04 19:30;22039;865;616;0;0;23520
2022-09-04 20:30;21888;962;619;0;0;23469
2022-09-04 21:30;21296;783;619;0;0;22698
2022-09-04 22:30;20571;862;624;0;0;22057
2022-09-04 23:30;19807;786;621;0;0;21214
2022-09-05 00:30;18628;848;622;0;0;20098
2022-09-05 01:30;17824;946;621;0;0;19391
2022-09-05 02:30;17430;976;618;0;0;19024
2022-09-05 03:30;16730;983;619;0;0;18332
2022-09-05 04:30;16973;971;616;0;0;18560
2022-09-05 05:30;17284;965;617;0;0;18866
2022-09-05 06:30;18184;933;617;0;0;19734
2022-09-05 07:30;19482;813;613;0;0;20908
2022-09-05 08:30;20826;685;604;1;0;22116
2022-09-05 09:30;21465;564;604;2;0;22635
2022-09-05 10:30;21828;429;603;3;0;22863
2022-09-05 11:30;22900;363;605;3;0;23871
2022-09-05 12:30;22918;293;607;4;0;23822
2022-09-05 13:30;22860;247;583;4;0;23694
2022-09-05 14:30;22454;234;582;2;0;23272
2022-09-05 15:30;21910;207;585;3;0;22705
2022-09-05 16:30;23226;168;584;1;0;23979
2022-09-05 17:30;23940;141;586;1;0;24668
2022-09-05 18:30;23790;187;588;1;0;24566
2022-09-05 19:30;23789;199;590;0;0;24578
2022-09-05 20:30;23515;322;592;0;0;24429
2022-09-05 21:30;22525;301;594;0;0;23420
2022-09-05 22:30;21724;309;598;0;0;22631
2022-09-05 23:30;20562;260;596;0;0;21418
2022-09-06 00:30;19132;334;599;0;0;20065
2022-09-06 01:30;18304;374;601;0;0;19279
2022-09-06 02:30;17548;320;597;0;0;18465
2022-09-06 03:30;17689;314;597;0;0;18600
2022-09-06 04:30;18231;337;596;0;0;19164
2022-09-06 05:30;19846;372;596;0;0;20814
2022-09-06 06:30;21876;315;595;0;0;22786
2022-09-06 07:30;23356;279;593;0;0;24228
2022-09-06 08:30;23855;191;567;1;0;24614
2022-09-06 09:30;24068;158;561;1;0;24788
2022-09-06 10:30;24128;135;561;1;0;24825
2022-09-06 11:30;24034;93;561;2;0;24690
2022-09-06 12:30;24123;71;562;4;0;24760
2022-09-06 13:30;24236;46;525;2;0;24809
2022-09-06 14:30;24011;30;525;4;0;24570
2022-09-06 15:30;24005;23;525;2;0;24555
2022-09-06 16:30;24247;45;526;1;0;24819
2022-09-06 17:30;24972;53;523;0;0;25548
2022-09-06 18:30;25076;90;525;0;0;25691
2022-09-06 19:30;24873;119;530;0;0;25522
2022-09-06 20:30;24936;91;537;0;0;25564
2022-09-06 21:30;23976;78;534;0;0;24588
2022-09-06 22:30;22572;111;538;0;0;23221
2022-09-06 23:30;21373;170;537;0;0;22080
2022-09-07 00:30;20775;194;537;0;0;21506
2022-09-07 01:30;20547;237;536;0;0;21320
2022-09-07 02:30;20106;228;541;0;0;20875
2022-09-07 03:30;19794;207;541;0;0;20542
2022-09-07 04:30;19911;204;540;0;0;20655
2022-09-07 05:30;20579;182;540;0;0;21301
2022-09-07 06:30;22198;126;542;0;0;22866
2022-09-07 07:30;23255;81;530;1;0;23867
2022-09-07 08:30;22686;32;526;1;0;23245
2022-09-07 09:30;22958;-4;527;4;0;23485
2022-09-07 10:30;23316;-7;528;0;0;23837
2022-09-07 11:30;22999;-3;531;0;0;23527
2022-09-07 12:30;22740;21;545;0;0;23306
2022-09-07 13:30;23393;57;550;0;0;24000
2022-09-07 14:30;22838;89;550;0;0;23477
2022-09-07 15:30;22598;104;551;0;0;23253
2022-09-07 16:30;23213;113;550;0;0;23876
2022-09-07 17:30;24378;92;551;3;160;25184
2022-09-07 18:30;23168;41;552;1;238;24000
2022-09-07 19:30;23629;27;552;0;0;24208
2022-09-07 20:30;22873;3;555;0;0;23431
2022-09-07 21:30;22567;18;555;0;0;23140
2022-09-07 22:30;21649;34;557;0;0;22240
2022-09-07 23:30;20354;80;557;0;0;20991
2022-09-08 00:30;19818;87;554;0;0;20459
2022-09-08 01:30;19728;137;554;0;0;20419
2022-09-08 02:30;19459;173;555;0;0;20187
2022-09-08 03:30;18685;132;556;0;0;19373
2022-09-08 04:30;18716;139;553;0;0;19408
2022-09-08 05:30;20115;121;554;0;0;20790
2022-09-08 06:30;21645;89;553;0;0;22287
2022-09-08 07:30;22003;115;553;1;0;22672
2022-09-08 08:30;22422;66;553;3;0;23044
2022-09-08 09:30;22352;65;552;5;0;22974
2022-09-08 10:30;22395;37;551;7;0;22990
2022-09-08 11:30;22429;43;553;8;0;23033
2022-09-08 12:30;22543;124;545;8;0;23220
2022-09-08 13:30;22672;107;544;8;0;23331
2022-09-08 14:30;22545;164;543;8;0;23260
2022-09-08 15:30;22635;132;543;7;0;23317
2022-09-08 16:30;23127;96;544;5;0;23772
2022-09-08 17:30;24116;51;551;3;0;24721
2022-09-08 18:30;24741;41;556;1;0;25339
2022-09-08 19:30;24741;56;552;0;0;25349
2022-09-08 20:30;24741;115;553;0;0;25409
2022-09-08 21:30;23814;46;552;0;0;24412
2022-09-08 22:30;22634;76;552;0;0;23262
2022-09-08 23:30;21236;99;556;0;0;21891
2022-09-09 00:30;20472;118;554;0;0;21144
2022-09-09 01:30;20235;105;552;0;0;20892
2022-09-09 02:30;18836;123;554;0;0;19513
2022-09-09 03:30;18467;136;552;0;0;19155
2022-09-09 04:30;18187;160;555;0;0;18902
2022-09-09 05:30;20070;184;553;0;0;20807
2022-09-09 06:30;22288;141;555;0;0;22984
2022-09-09 07:30;23476;102;553;0;0;24131
2022-09-09 08:30;23873;41;557;2;0;24473
2022-09-09 09:30;23442;6;557;5;0;24010
2022-09-09 10:30;23794;24;554;6;0;24378
2022-09-09 11:30;23855;67;553;7;0;24482
2022-09-09 12:30;24006;68;549;8;0;24631
2022-09-09 13:30;24278;77;548;8;0;24911
2022-09-09 14:30;23487;83;547;6;0;24123
2022-09-09 15:30;23430;69;547;4;0;24050
2022-09-09 16:30;23488;94;546;4;0;24132
2022-09-09 17:30;23741;136;548;2;0;24427
2022-09-09 18:30;24004;154;552;1;0;24711
2022-09-09 19:30;23930;197;552;0;0;24679
2022-09-09 20:30;23310;307;557;0;0;24174
2022-09-09 21:30;22508;393;551;0;0;23452
2022-09-09 22:30;21684;480;551;0;0;22715
2022-09-09 23:30;20175;473;549;0;0;21197
2022-09-10 00:30;20335;489;551;0;0;21375
2022-09-10 01:30;19153;574;550;0;0;20277
2022-09-10 02:30;18417;542;551;0;0;19510
2022-09-10 03:30;17192;544;550;0;0;18286
2022-09-10 04:30;17129;478;552;0;0;18159
2022-09-10 05:30;17221;460;555;0;0;18236
2022-09-10 06:30;18060;397;555;0;0;19012
2022-09-10 07:30;19559;275;553;1;0;20388
2022-09-10 08:30;21698;129;555;2;0;22384
2022-09-10 09:30;22667;33;552;4;0;23256
2022-09-10 10:30;23181;17;547;6;0;23751
2022-09-10 11:30;23504;43;548;7;0;24102
2022-09-10 12:30;23796;68;552;8;0;24424
2022-09-10 13:30;23856;96;552;8;0;24512
2022-09-10 14:30;23741;124;550;8;0;24423
2022-09-10 15:30;23488;165;548;5;0;24206
2022-09-10 16:30;23561;209;550;3;0;24323
2022-09-10 17:30;24290;279;548;1;0;25118
2022-09-10 18:30;23864;358;554;0;0;24776
2022-09-10 19:30;23771;570;554;0;0;24895
2022-09-10 20:30;23319;628;554;0;0;24501
2022-09-10 21:30;22593;703;554;0;0;23850
2022-09-10 22:30;21446;701;554;0;0;22701
2022-09-10 23:30;20127;741;551;0;0;21419
2022-09-11 00:30;19371;746;553;0;0;20670
2022-09-11 01:30;18337;777;549;0;0;19663
2022-09-11 02:30;17320;708;552;0;0;18580
2022-09-11 03:30;17183;570;550;0;0;18303
2022-09-11 04:30;17266;427;551;0;0;18244
2022-09-11 05:30;17337;293;551;0;0;18181
2022-09-11 06:30;18271;230;550;0;0;19051
2022-09-11 07:30;19482;161;549;1;0;20193
2022-09-11 08:30;21446;71;548;2;0;22067
2022-09-11 09:30;22416;12;547;5;0;22980
2022-09-11 10:30;22460;15;542;7;0;23024
2022-09-11 11:30;23122;30;542;8;0;23702
2022-09-11 12:30;23497;45;507;8;0;24057
2022-09-11 13:30;24357;49;508;8;0;24922
2022-09-11 14:30;24261;62;508;7;0;24838
2022-09-11 15:30;24042;76;504;6;0;24628
2022-09-11 16:30;24789;101;507;3;0;25400
2022-09-11 17:30;25124;150;507;2;0;25783
2022-09-11 18:30;25017;210;510;0;0;25737
2022-09-11 19:30;24762;211;514;0;0;25487
2022-09-11 20:30;24189;192;516;0;0;24897
2022-09-11 21:30;23006;286;515;0;0;23807
2022-09-11 22:30;22049;302;518;0;0;22869
2022-09-11 23:30;20947;220;510;0;0;21677
2022-09-12 00:30;20567;190;511;0;0;21268
2022-09-12 01:30;19168;211;509;0;0;19888
2022-09-12 02:30;18081;201;509;0;0;18791
2022-09-12 03:30;17502;236;509;0;0;18247
2022-09-12 04:30;17702;283;509;0;0;18494
2022-09-12 05:30;19134;284;507;0;0;19925
2022-09-12 06:30;22027;243;509;0;0;22779
2022-09-12 07:30;23699;173;505;0;0;24377
2022-09-12 08:30;24291;104;505;1;0;24901
2022-09-12 09:30;23265;53;502;5;0;23825
2022-09-12 10:30;23744;27;498;5;0;24274
2022-09-12 11:30;23511;38;503;8;0;24060
2022-09-12 12:30;23595;39;524;8;0;24166
2022-09-12 13:30;24045;60;524;8;0;24637
2022-09-12 14:30;24029;51;524;7;0;24611
2022-09-12 15:30;23717;51;526;6;0;24300
2022-09-12 16:30;24076;63;523;5;0;24667
2022-09-12 17:30;24948;57;529;3;0;25537
2022-09-12 18:30;24723;64;530;0;0;25317
2022-09-12 19:30;25573;38;532;0;0;26143
2022-09-12 20:30;24807;40;535;0;0;25382
2022-09-12 21:30;24250;35;536;0;0;24821
2022-09-12 22:30;23521;43;539;0;0;24103
2022-09-12 23:30;21987;24;536;0;0;22547
2022-09-13 00:30;20917;2;534;0;0;21453
2022-09-13 01:30;20729;-5;533;0;0;21257
2022-09-13 02:30;20610;11;532;0;0;21153
2022-09-13 03:30;19528;32;526;0;0;20086
2022-09-13 04:30;18873;63;518;0;0;19454
2022-09-13 05:30;20313;71;513;0;0;20897
2022-09-13 06:30;22088;107;509;0;0;22704
2022-09-13 07:30;22818;165;505;0;0;23488
2022-09-13 08:30;22591;148;506;1;0;23246
2022-09-13 09:30;22451;136;502;1;0;23090
2022-09-13 10:30;22422;127;506;3;0;23058
2022-09-13 11:30;23333;132;509;1;0;23975
2022-09-13 12:30;23289;161;506;0;0;23956
2022-09-13 13:30;23232;155;507;0;0;23894
2022-09-13 14:30;23141;183;506;2;0;23832
2022-09-13 15:30;22404;291;507;2;0;23204
2022-09-13 16:30;22991;350;509;0;0;23850
2022-09-13 17:30;24100;466;512;0;0;25078
2022-09-13 18:30;24416;688;512;0;0;25616
2022-09-13 19:30;23808;909;514;0;0;25231
2022-09-13 20:30;22717;1199;517;0;0;24433
2022-09-13 21:30;21292;1249;518;0;0;23059
2022-09-13 22:30;20627;1352;522;0;0;22501
2022-09-13 23:30;18839;1637;524;0;0;21000
2022-09-14 00:30;18473;1563;528;0;0;20564
2022-09-14 01:30;18152;1254;533;0;0;19939
2022-09-14 02:30;17024;1338;539;0;0;18901
2022-09-14 03:30;16362;1603;537;0;0;18502
2022-09-14 04:30;16512;1610;534;0;0;18656
2022-09-14 05:30;17805;1717;536;0;0;20058
2022-09-14 06:30;20041;1818;537;0;0;22396
2022-09-14 07:30;21566;1672;536;0;0;23774
2022-09-14 08:30;21295;2016;533;2;0;23846
2022-09-14 09:30;21899;1839;533;4;0;24275
2022-09-14 10:30;21598;2048;531;5;0;24182
2022-09-14 11:30;22004;2146;527;5;0;24682
2022-09-14 12:30;21822;1818;527;7;0;24174
2022-09-14 13:30;21742;2045;485;8;0;24280
2022-09-14 14:30;21645;1927;485;6;0;24063
2022-09-14 15:30;21386;1994;482;3;0;23865
2022-09-14 16:30;21164;2272;485;2;0;23923
2022-09-14 17:30;21573;2398;485;1;0;24457
2022-09-14 18:30;21574;2383;486;0;0;24443
2022-09-14 19:30;21409;2582;489;0;0;24480
2022-09-14 20:30;20710;2669;494;0;0;23873
2022-09-14 21:30;19895;2667;515;0;0;23077
2022-09-14 22:30;18773;2629;512;0;0;21914
2022-09-14 23:30;16897;2619;514;0;0;20030
2022-09-15 00:30;16598;2609;515;0;0;19722
2022-09-15 01:30;14781;2567;515;0;0;17863
2022-09-15 02:30;14874;2638;515;0;0;18027
2022-09-15 03:30;14129;2680;513;0;0;17322
2022-09-15 04:30;14150;2683;513;0;0;17346
2022-09-15 05:30;16082;2632;512;0;0;19226
2022-09-15 06:30;18599;2606;514;0;0;21719
2022-09-15 07:30;19857;2661;515;0;0;23033
2022-09-15 08:30;20070;2590;512;3;0;23175
2022-09-15 09:30;19702;2575;507;6;0;22790
2022-09-15 10:30;19393;2483;505;8;0;22389
2022-09-15 11:30;20216;2489;507;8;0;23220
2022-09-15 12:30;20167;2575;508;8;0;23258
2022-09-15 13:30;19214;2593;492;8;0;22307
2022-09-15 14:30;19046;2589;493;8;0;22136
2022-09-15 15:30;19044;2625;496;7;0;22172
2022-09-15 16:30;19820;2590;499;5;0;22914
2022-09-15 17:30;20916;2554;499;3;0;23972
2022-09-15 18:30;21272;2381;501;1;0;24155
2022-09-15 19:30;21517;2428;506;0;0;24451
2022-09-15 20:30;20846;2480;510;0;0;23836
2022-09-15 21:30;19947;2452;512;0;0;22911
2022-09-15 22:30;18697;2423;503;0;0;21623
2022-09-15 23:30;17440;2320;503;0;0;20263
2022-09-16 00:30;16341;2327;503;0;0;19171
2022-09-16 01:30;15739;2313;505;0;0;18557
2022-09-16 02:30;15267;2264;507;0;0;18038
2022-09-16 03:30;15153;2225;511;0;0;17889
2022-09-16 04:30;14967;2218;512;0;0;17697
2022-09-16 05:30;15887;2231;507;0;0;18625
2022-09-16 06:30;18382;2269;507;0;0;21158
2022-09-16 07:30;19710;2291;506;0;0;22507
2022-09-16 08:30;20520;2258;504;3;0;23285
2022-09-16 09:30;20707;2152;507;5;0;23371
2022-09-16 10:30;20857;2275;504;7;0;23643
2022-09-16 11:30;20766;2334;506;6;0;23612
2022-09-16 12:30;20420;2401;504;6;0;23331
2022-09-16 13:30;20148;2407;541;6;0;23102
2022-09-16 14:30;19941;2217;546;7;0;22711
2022-09-16 15:30;19943;2163;546;7;0;22659
2022-09-16 16:30;20591;2428;546;3;0;23568
2022-09-16 17:30;20867;2429;547;2;0;23845
2022-09-16 18:30;21033;2308;547;1;0;23889
2022-09-16 19:30;21254;2225;548;0;0;24027
2022-09-16 20:30;20889;2375;549;0;0;23813
2022-09-16 21:30;19970;2377;551;0;0;22898
2022-09-16 22:30;18695;2337;556;0;0;21588
2022-09-16 23:30;18086;2208;557;0;0;20851
2022-09-17 00:30;16841;2273;555;0;0;19669
2022-09-17 01:30;16501;2104;555;0;0;19160
2022-09-17 02:30;16620;1903;554;0;0;19077
2022-09-17 03:30;16305;1783;555;0;0;18643
2022-09-17 04:30;16433;1646;555;0;0;18634
2022-09-17 05:30;16998;1550;554;0;0;19102
2022-09-17 06:30;18112;1490;555;0;0;20157
2022-09-17 07:30;19072;1445;556;0;0;21073
2022-09-17 08:30;19648;1354;551;3;0;21556
2022-09-17 09:30;20579;1435;550;6;0;22570
2022-09-17 10:30;20416;1524;544;7;0;22491
2022-09-17 11:30;20102;1833;543;6;0;22484
2022-09-17 12:30;20205;2016;548;6;0;22775
2022-09-17 13:30;19839;2066;567;6;0;22478
2022-09-17 14:30;18681;2060;568;6;0;21315
2022-09-17 15:30;18792;2150;567;5;0;21514
2022-09-17 16:30;20039;2135;564;5;0;22743
2022-09-17 17:30;20874;2007;565;1;0;23447
2022-09-17 18:30;20994;1942;566;0;0;23502
2022-09-17 19:30;20651;2209;567;0;0;23427
2022-09-17 20:30;19998;2289;575;0;0;22862
2022-09-17 21:30;18943;2417;575;0;0;21935
2022-09-17 22:30;17938;2311;576;0;0;20825
2022-09-17 23:30;17273;2211;576;0;0;20060
2022-09-18 00:30;16191;1895;576;0;0;18662
2022-09-18 01:30;15402;1566;574;0;0;17542
2022-09-18 02:30;14417;1440;573;0;0;16430
2022-09-18 03:30;14680;1314;572;0;0;16566
2022-09-18 04:30;14711;1315;571;0;0;16597
2022-09-18 05:30;14236;1243;571;0;0;16050
2022-09-18 06:30;15749;1213;570;0;0;17532
2022-09-18 07:30;17174;1016;568;1;0;18759
2022-09-18 08:30;18400;914;567;1;0;19882
2022-09-18 09:30;19586;796;568;0;0;20950
2022-09-18 10:30;20575;738;564;0;0;21877
2022-09-18 11:30;21289;759;564;1;0;22613
2022-09-18 12:30;21896;696;561;2;0;23155
2022-09-18 13:30;21886;645;560;1;0;23092
2022-09-18 14:30;21884;647;560;1;0;23092
2022-09-18 15:30;22176;575;557;0;0;23308
2022-09-18 16:30;22704;533;558;0;0;23795
2022-09-18 17:30;23844;503;557;0;0;24904
2022-09-18 18:30;23740;536;559;0;0;24835
2022-09-18 19:30;23302;633;560;0;0;24495
2022-09-18 20:30;22373;741;562;0;0;23676
2022-09-18 21:30;21386;797;564;0;0;22747
2022-09-18 22:30;19822;773;564;0;0;21159
2022-09-18 23:30;18554;804;560;0;0;19918
2022-09-19 00:30;17316;709;559;0;0;18584
2022-09-19 01:30;17357;753;558;0;0;18668
2022-09-19 02:30;16926;676;556;0;0;18158
2022-09-19 03:30;16536;645;556;0;0;17737
2022-09-19 04:30;16447;555;555;0;0;17557
2022-09-19 05:30;17696;588;554;0;0;18838
2022-09-19 06:30;19584;554;556;0;0;20694
2022-09-19 07:30;21304;515;557;0;0;22376
2022-09-19 08:30;22212;469;563;0;0;23244
2022-09-19 09:30;22561;366;556;0;0;23483
2022-09-19 10:30;22684;365;555;0;0;23604
2022-09-19 11:30;22745;374;558;0;0;23677
2022-09-19 12:30;22314;389;590;1;0;23294
2022-09-19 13:30;21778;529;590;1;0;22898
2022-09-19 14:30;22301;625;590;1;0;23517
2022-09-19 15:30;22372;615;588;0;0;23575
2022-09-19 16:30;22637;720;587;0;0;23944
2022-09-19 17:30;23401;826;588;0;0;24815
2022-09-19 18:30;23163;984;588;0;0;24735
2022-09-19 19:30;22885;1155;590;0;0;24630
2022-09-19 20:30;21679;1331;592;0;0;23602
2022-09-19 21:30;20735;1328;591;0;0;22654
2022-09-19 22:30;19520;1504;591;0;0;21615
2022-09-19 23:30;18411;1547;592;0;0;20550
2022-09-20 00:30;17238;1578;593;0;0;19409
2022-09-20 01:30;16290;1604;593;0;0;18487
2022-09-20 02:30;15581;1513;594;0;0;17688
2022-09-20 03:30;15055;1567;595;0;0;17217
2022-09-20 04:30;14390;1590;594;0;0;16574
2022-09-20 05:30;15928;1467;589;0;0;17984
2022-09-20 06:30;18271;1546;589;0;0;20406
2022-09-20 07:30;20246;1569;584;0;0;22399
2022-09-20 08:30;20790;1497;583;0;0;22870
2022-09-20 09:30;21123;1485;585;1;0;23194
2022-09-20 10:30;21258;1361;584;1;0;23204
2022-09-20 11:30;21093;1243;584;1;0;22921
2022-09-20 12:30;21196;1076;585;1;0;22858
2022-09-20 13:30;21026;1032;562;1;0;22621
2022-09-20 14:30;20601;875;562;1;0;22039
2022-09-20 15:30;21071;864;564;1;0;22500
2022-09-20 16:30;21279;930;560;2;0;22771
2022-09-20 17:30;22578;844;563;1;0;23986
2022-09-20 18:30;22694;749;560;0;0;24003
2022-09-20 19:30;22547;893;565;0;0;24005
2022-09-20 20:30;21613;940;561;0;0;23114
2022-09-20 21:30;20943;880;561;0;0;22384
2022-09-20 22:30;20120;757;565;0;0;21442
2022-09-20 23:30;18442;640;568;0;0;19650
2022-09-21 00:30;17233;629;569;0;0;18431
2022-09-21 01:30;16645;537;564;0;0;17746
2022-09-21 02:30;15793;411;566;0;0;16770
2022-09-21 03:30;15577;334;565;0;0;16476
2022-09-21 04:30;16086;285;558;0;0;16929
2022-09-21 05:30;17657;195;555;0;0;18407
2022-09-21 06:30;20041;224;554;0;0;20819
2022-09-21 07:30;21495;161;556;0;0;22212
2022-09-21 08:30;21760;102;557;1;0;22420
2022-09-21 09:30;21760;49;561;2;0;22372
2022-09-21 10:30;21362;35;559;3;0;21959
2022-09-21 11:30;21701;52;559;2;0;22314
2022-09-21 12:30;21479;45;574;2;0;22100
2022-09-21 13:30;22106;46;576;2;0;22730
2022-09-21 14:30;21960;83;572;1;0;22616
2022-09-21 15:30;21417;139;567;4;0;22127
2022-09-21 16:30;21600;221;574;4;0;22399
2022-09-21 17:30;22876;355;570;1;0;23802
2022-09-21 18:30;22506;698;571;0;0;23775
2022-09-21 19:30;22406;960;571;0;0;23937
2022-09-21 20:30;21820;1088;571;0;0;23479
2022-09-21 21:30;20056;1412;570;0;0;22038
2022-09-21 22:30;18209;1622;572;0;0;20403
2022-09-21 23:30;16056;1757;573;0;0;18386
2022-09-22 00:30;14684;1942;569;0;0;17195
2022-09-22 01:30;14159;1925;568;0;0;16652
2022-09-22 02:30;13463;2145;569;0;0;16177
2022-09-22 03:30;13208;2177;571;0;0;15956
2022-09-22 04:30;13574;2087;570;0;0;16231
2022-09-22 05:30;14652;2101;569;0;0;17322
2022-09-22 06:30;16561;1962;570;0;0;19093
2022-09-22 07:30;18709;1696;570;0;0;20975
2022-09-22 08:30;18907;1544;574;0;0;21025
2022-09-22 09:30;18093;1662;572;1;0;20328
2022-09-22 10:30;18026;1614;568;7;0;20215
2022-09-22 11:30;18636;1316;570;8;0;20530
2022-09-22 12:30;18381;1318;575;8;0;20282
2022-09-22 13:30;18488;1047;574;4;0;20113
2022-09-22 14:30;18130;1253;575;3;100;20061
2022-09-22 15:30;17836;1240;575;1;0;19652
2022-09-22 16:30;18370;1317;575;1;0;20263
2022-09-22 17:30;19271;1270;571;1;0;21113
2022-09-22 18:30;19257;1600;574;0;0;21431
2022-09-22 19:30;19467;1842;576;0;0;21885
2022-09-22 20:30;18475;1961;575;0;0;21011
2022-09-22 21:30;17789;1851;575;0;0;20215
2022-09-22 22:30;16284;2107;582;0;0;18973
2022-09-22 23:30;14491;2283;585;0;0;17359
2022-09-23 00:30;13641;2408;583;0;0;16632
2022-09-23 01:30;13765;2314;583;0;0;16662
2022-09-23 02:30;13055;2145;583;0;0;15783
2022-09-23 03:30;12970;2248;582;0;0;15800
2022-09-23 04:30;13326;2601;582;0;0;16509
2022-09-23 05:30;14593;2299;582;0;0;17474
2022-09-23 06:30;16689;2221;581;0;0;19491
2022-09-23 07:30;18841;2638;580;0;0;22059
2022-09-23 08:30;18629;2666;585;1;0;21881
2022-09-23 09:30;18231;2182;585;5;0;21003
2022-09-23 10:30;17751;2207;587;3;0;20548
2022-09-23 11:30;17863;2363;589;7;0;20822
2022-09-23 12:30;17676;2171;617;8;0;20472
2022-09-23 13:30;17426;2123;617;6;0;20172
2022-09-23 14:30;17119;2114;616;8;0;19857
2022-09-23 15:30;16962;2229;617;6;0;19814
2022-09-23 16:30;16985;2415;615;5;0;20020
2022-09-23 17:30;18690;2452;615;2;0;21759
2022-09-23 18:30;19198;2543;615;0;0;22356
2022-09-23 19:30;19100;2463;615;0;0;22178
2022-09-23 20:30;18707;2594;616;0;0;21917
2022-09-23 21:30;17710;2548;620;0;0;20878
2022-09-23 22:30;15948;2504;621;0;0;19073
2022-09-23 23:30;14752;2558;617;0;0;17927
2022-09-24 00:30;13876;2598;618;0;0;17092
2022-09-24 01:30;13598;2561;614;0;0;16773
2022-09-24 02:30;13236;2623;616;0;0;16475
2022-09-24 03:30;13095;2672;617;0;0;16384
2022-09-24 04:30;13176;2703;618;0;0;16497
2022-09-24 05:30;13565;2715;616;0;0;16896
2022-09-24 06:30;14306;2635;617;0;0;17558
2022-09-24 07:30;15743;2600;617;0;0;18960
2022-09-24 08:30;16231;2500;616;3;0;19350
2022-09-24 09:30;16304;2362;618;5;0;19289
2022-09-24 10:30;16399;2319;618;7;0;19343
2022-09-24 11:30;16156;2334;614;8;0;19112
2022-09-24 12:30;16175;2248;631;8;0;19062
2022-09-24 13:30;15334;2367;637;8;0;18346
2022-09-24 14:30;14692;2590;638;7;0;17927
2022-09-24 15:30;14552;2700;640;7;0;17899
2022-09-24 16:30;14794;2716;640;5;0;18155
2022-09-24 17:30;15730;2644;633;2;0;19009
2022-09-24 18:30;16161;2561;633;0;0;19355
2022-09-24 19:30;16456;2629;632;0;0;19717
2022-09-24 20:30;15637;2510;635;0;0;18782
2022-09-24 21:30;14763;2443;635;0;0;17841
2022-09-24 22:30;14233;2354;636;0;0;17223
2022-09-24 23:30;13473;2280;638;0;0;16391
2022-09-25 00:30;12972;2078;636;0;0;15686
2022-09-25 01:30;12693;1940;636;0;0;15269
2022-09-25 02:30;12790;2221;636;0;0;15647
2022-09-25 03:30;12816;1815;637;0;0;15268
2022-09-25 04:30;12971;1613;637;0;0;15221
2022-09-25 05:30;13315;1997;636;0;0;15948
2022-09-25 06:30;13989;1939;633;0;0;16561
2022-09-25 07:30;14961;1672;629;0;0;17262
2022-09-25 08:30;16928;1291;633;0;0;18852
2022-09-25 09:30;17534;1153;634;1;0;19322
2022-09-25 10:30;17732;1010;633;2;0;19377
2022-09-25 11:30;17736;1007;628;4;0;19375
2022-09-25 12:30;17548;1064;638;3;0;19253
2022-09-25 13:30;17572;912;641;8;0;19133
2022-09-25 14:30;17512;652;640;4;0;18808
2022-09-25 15:30;17869;376;639;1;0;18885
2022-09-25 16:30;18741;254;634;1;0;19630
2022-09-25 17:30;19831;289;633;0;0;20753
2022-09-25 18:30;20278;331;639;0;0;21248
2022-09-25 19:30;20373;338;641;0;0;21352
2022-09-25 20:30;19040;341;644;0;0;20025
2022-09-25 21:30;17837;237;646;0;0;18720
2022-09-25 22:30;16962;280;651;0;0;17893
2022-09-25 23:30;15623;383;648;0;0;16654
2022-09-26 00:30;14821;497;649;0;0;15967
2022-09-26 01:30;14407;502;648;0;0;15557
2022-09-26 02:30;14309;465;649;0;0;15423
2022-09-26 03:30;14443;455;648;0;0;15546
2022-09-26 04:30;14763;358;647;0;0;15768
2022-09-26 05:30;16069;385;635;0;0;17089
2022-09-26 06:30;17868;402;624;0;0;18894
2022-09-26 07:30;19243;502;612;0;0;20357
2022-09-26 08:30;19815;453;599;1;0;20868
2022-09-26 09:30;19858;458;594;1;0;20911
2022-09-26 10:30;19741;397;588;1;0;20727
2022-09-26 11:30;19806;381;590;2;0;20779
2022-09-26 12:30;19426;371;557;4;0;20358
2022-09-26 13:30;19747;382;560;3;0;20692
2022-09-26 14:30;19083;240;557;4;0;19884
2022-09-26 15:30;18988;198;556;2;0;19744
2022-09-26 16:30;20486;110;559;1;0;21156
2022-09-26 17:30;21442;129;560;0;0;22131
2022-09-26 18:30;21118;236;575;0;0;21929
2022-09-26 19:30;21093;348;587;0;0;22028
2022-09-26 20:30;19878;476;604;0;0;20958
2022-09-26 21:30;18661;561;616;0;0;19838
2022-09-26 22:30;17336;487;615;0;0;18438
2022-09-26 23:30;15691;688;616;0;0;16995
2022-09-27 00:30;15173;682;615;0;0;16470
2022-09-27 01:30;14729;631;616;0;0;15976
2022-09-27 02:30;14326;791;615;0;0;15732
2022-09-27 03:30;14103;812;616;0;0;15531
2022-09-27 04:30;14192;819;617;0;0;15628
2022-09-27 05:30;15119;855;615;0;0;16589
2022-09-27 06:30;17489;941;615;0;0;19045
2022-09-27 07:30;18534;1212;613;0;0;20359
2022-09-27 08:30;18773;1166;611;0;0;20550
2022-09-27 09:30;18760;1086;612;1;0;20459
2022-09-27 10:30;18733;921;610;1;0;20265
2022-09-27 11:30;18980;753;606;2;0;20341
2022-09-27 12:30;18710;717;594;2;0;20023
2022-09-27 13:30;18658;611;600;2;0;19871
2022-09-27 14:30;18510;566;599;1;0;19676
2022-09-27 15:30;18524;509;598;4;0;19635
2022-09-27 16:30;19205;402;598;3;0;20208
2022-09-27 17:30;20073;504;601;2;0;21180
2022-09-27 18:30;20237;661;608;0;0;21506
2022-09-27 19:30;20487;784;611;0;0;21882
2022-09-27 20:30;19220;961;615;0;0;20796
2022-09-27 21:30;17699;1101;613;0;0;19413
2022-09-27 22:30;16598;890;611;0;0;18099
2022-09-27 23:30;15449;797;613;0;0;16859
2022-09-28 00:30;14313;734;610;0;0;15657
2022-09-28 01:30;14176;740;610;0;0;15526
2022-09-28 02:30;13707;598;609;0;0;14914
2022-09-28 03:30;13681;499;609;0;0;14789
2022-09-28 04:30;14137;431;610;0;0;15178
2022-09-28 05:30;15722;361;611;0;0;16694
2022-09-28 06:30;18113;257;609;0;0;18979
2022-09-28 07:30;20032;227;608;0;0;20867
2022-09-28 08:30;20092;232;608;0;0;20932
2022-09-28 09:30;19563;206;606;1;0;20376
2022-09-28 10:30;18743;241;607;2;0;19593
2022-09-28 11:30;18704;304;606;3;0;19617
2022-09-28 12:30;18394;399;600;4;0;19397
2022-09-28 13:30;18235;659;600;2;0;19496
2022-09-28 14:30;17922;876;600;3;0;19401
2022-09-28 15:30;18109;917;601;4;0;19631
2022-09-28 16:30;18888;1031;601;1;0;20521
2022-09-28 17:30;19792;1031;604;1;0;21428
2022-09-28 18:30;20322;1168;606;0;0;22096
2022-09-28 19:30;20873;1348;611;0;0;22832
2022-09-28 20:30;19738;1531;611;0;0;21880
2022-09-28 21:30;17573;1685;610;0;0;19868
2022-09-28 22:30;15840;1579;610;0;0;18029
2022-09-28 23:30;14784;1563;608;0;0;16955
2022-09-29 00:30;14392;1516;605;0;0;16513
2022-09-29 01:30;14261;1425;599;0;0;16285
2022-09-29 02:30;13849;1424;597;0;0;15870
2022-09-29 03:30;13689;1498;596;0;0;15783
2022-09-29 04:30;14241;1339;596;0;0;16176
2022-09-29 05:30;15161;1363;597;0;0;17121
2022-09-29 06:30;17918;1371;598;0;0;19887
2022-09-29 07:30;19987;1318;600;0;0;21905
2022-09-29 08:30;19932;1424;601;1;0;21958
2022-09-29 09:30;18588;1273;592;3;0;20456
2022-09-29 10:30;18555;1204;590;4;0;20353
2022-09-29 11:30;18243;1256;585;3;0;20087
2022-09-29 12:30;17952;1211;605;3;0;19771
2022-09-29 13:30;17832;1230;608;5;0;19675
2022-09-29 14:30;17348;1347;606;8;0;19309
2022-09-29 15:30;17924;1210;605;7;0;19746
2022-09-29 16:30;18782;1101;605;4;0;20492
2022-09-29 17:30;20660;1015;607;2;0;22284
2022-09-29 18:30;21280;1360;611;0;0;23251
2022-09-29 19:30;21284;1757;611;0;0;23652
2022-09-29 20:30;20727;1777;612;0;0;23116
2022-09-29 21:30;18866;1752;612;0;0;21230
2022-09-29 22:30;16608;1892;608;0;0;19108
2022-09-29 23:30;15139;2021;611;0;0;17771
2022-09-30 00:30;14341;2001;612;0;0;16954
2022-09-30 01:30;14468;1990;618;0;0;17076
2022-09-30 02:30;14394;1881;624;0;0;16899
2022-09-30 03:30;14379;1819;622;0;0;16820
2022-09-30 04:30;15280;1690;622;0;0;17592
2022-09-30 05:30;16981;1520;612;0;0;19113
2022-09-30 06:30;19700;1246;602;0;0;21548
2022-09-30 07:30;20790;1203;591;0;0;22584
2022-09-30 08:30;20992;998;579;3;0;22572
2022-09-30 09:30;20271;713;578;5;0;21567
2022-09-30 10:30;19313;705;572;7;0;20597
2022-09-30 11:30;19063;782;570;8;0;20423
2022-09-30 12:30;18503;818;569;8;0;19898
2022-09-30 13:30;18103;867;583;8;0;19561
2022-09-30 14:30;17553;818;587;8;0;18966
2022-09-30 15:30;17662;785;596;7;0;19050
2022-09-30 16:30;18332;873;608;3;0;19816
2022-09-30 17:30;19501;1218;610;1;0;21330
2022-09-30 18:30;19033;1725;613;0;0;21371
2022-09-30 19:30;19202;2083;615;0;0;21900
2022-09-30 20:30;18123;2271;617;0;0;21011
2022-09-30 21:30;16076;2307;614;0;0;18997
2022-09-30 22:30;15414;2370;615;0;0;18399
2022-09-30 23:30;13897;2367;612;0;0;16876
2022-10-01 00:30;14008;2325;612;0;0;16945
2022-10-01 01:30;14253;1885;611;0;0;16749
2022-10-01 02:30;14430;1969;606;0;0;17005
2022-10-01 03:30;14752;1659;603;0;0;17014
2022-10-01 04:30;15048;1473;603;0;0;17124
2022-10-01 05:30;15592;1433;602;0;0;17627
2022-10-01 06:30;16441;1320;605;0;0;18366
2022-10-01 07:30;17850;978;602;0;0;19430
2022-10-01 08:30;18983;681;599;1;0;20264
2022-10-01 09:30;19834;465;603;2;0;20904
2022-10-01 10:30;19492;423;602;4;0;20521
2022-10-01 11:30;20734;424;600;4;0;21762
2022-10-01 12:30;19562;495;586;3;0;20646
2022-10-01 13:30;18864;756;585;4;0;20209
2022-10-01 14:30;18343;943;578;4;0;19868
2022-10-01 15:30;17861;1035;579;3;0;19478
2022-10-01 16:30;18130;1124;582;2;0;19838
2022-10-01 17:30;19142;944;583;1;0;20670
2022-10-01 18:30;19297;1145;588;0;0;21030
2022-10-01 19:30;18774;1479;597;0;0;20850
2022-10-01 20:30;17965;1700;593;0;0;20258
2022-10-01 21:30;16721;1652;593;0;0;18966
2022-10-01 22:30;15472;1751;595;0;0;17818
2022-10-01 23:30;14860;1651;594;0;0;17105
2022-10-02 00:30;14566;1679;594;0;0;16839
2022-10-02 01:30;14010;1866;598;0;0;16474
2022-10-02 02:30;14165;1810;600;0;0;16575
2022-10-02 03:30;14312;1667;601;0;0;16580
2022-10-02 04:30;14785;1637;600;0;0;17022
2022-10-02 05:30;15238;1538;599;0;0;17375
2022-10-02 06:30;16360;1344;601;0;0;18305
2022-10-02 07:30;17995;1089;602;0;0;19686
2022-10-02 08:30;18884;920;599;3;0;20406
2022-10-02 09:30;19665;771;600;5;0;21041
2022-10-02 10:30;19508;632;596;8;0;20744
2022-10-02 11:30;18921;672;596;8;0;20197
2022-10-02 12:30;18645;697;579;8;0;19929
2022-10-02 13:30;17708;770;573;8;0;19059
2022-10-02 14:30;17172;736;573;8;0;18489
2022-10-02 15:30;17362;643;575;5;0;18585
2022-10-02 16:30;18877;486;575;4;0;19942
2022-10-02 17:30;20861;349;572;2;0;21784
2022-10-02 18:30;21798;405;576;0;0;22779
2022-10-02 19:30;22422;461;583;0;0;23466
2022-10-02 20:30;21553;493;586;0;0;22632
2022-10-02 21:30;20102;584;584;0;0;21270
2022-10-02 22:30;18576;619;583;0;0;19778
2022-10-02 23:30;17573;636;583;0;0;18792
2022-10-03 00:30;17317;599;579;0;0;18495
2022-10-03 01:30;17259;528;581;0;0;18368
2022-10-03 02:30;17085;513;582;0;0;18180
2022-10-03 03:30;17363;450;582;0;0;18395
2022-10-03 04:30;18406;397;582;0;0;19385
2022-10-03 05:30;20304;447;579;0;0;21330
2022-10-03 06:30;21860;576;579;0;0;23015
2022-10-03 07:30;22913;658;576;0;0;24147
2022-10-03 08:30;22815;580;573;3;0;23971
2022-10-03 09:30;22964;405;569;5;0;23943
2022-10-03 10:30;22172;364;567;7;0;23110
2022-10-03 11:30;21963;328;570;8;0;22869
2022-10-03 12:30;21489;276;570;8;0;22343
2022-10-03 13:30;21044;297;547;8;0;21896
2022-10-03 14:30;20741;303;547;8;0;21599
2022-10-03 15:30;20430;335;548;7;0;21320
2022-10-03 16:30;20608;297;549;5;0;21459
2022-10-03 17:30;21972;341;550;2;0;22865
2022-10-03 18:30;21927;734;551;0;0;23212
2022-10-03 19:30;22156;1094;557;0;0;23807
2022-10-03 20:30;21796;1357;554;0;0;23707
2022-10-03 21:30;20958;1354;552;0;0;22864
2022-10-03 22:30;19345;1386;552;0;0;21283
2022-10-03 23:30;17827;1329;555;0;0;19711
2022-10-04 00:30;17884;1160;553;0;0;19597
2022-10-04 01:30;17619;1249;552;0;0;19420
2022-10-04 02:30;17565;1239;554;0;0;19358
2022-10-04 03:30;17733;1342;555;0;0;19630
2022-10-04 04:30;18036;1389;553;0;0;19978
2022-10-04 05:30;19372;1191;553;0;0;21116
2022-10-04 06:30;21786;975;553;0;0;23314
2022-10-04 07:30;23024;825;551;0;0;24400
2022-10-04 08:30;22457;492;551;3;0;23503
2022-10-04 09:30;22603;477;549;4;0;23633
2022-10-04 10:30;22121;330;547;7;0;23005
2022-10-04 11:30;21894;279;542;8;0;22723
2022-10-04 12:30;21318;242;518;8;0;22086
2022-10-04 13:30;21515;195;522;7;0;22239
2022-10-04 14:30;21106;201;515;7;0;21829
2022-10-04 15:30;21275;168;520;4;0;21967
2022-10-04 16:30;21418;196;522;5;0;22141
2022-10-04 17:30;21425;220;522;1;0;22168
2022-10-04 18:30;21754;356;526;0;0;22636
2022-10-04 19:30;21722;415;529;0;0;22666
2022-10-04 20:30;21479;523;534;0;0;22536
2022-10-04 21:30;21232;515;532;0;0;22279
2022-10-04 22:30;19670;525;532;0;0;20727
2022-10-04 23:30;18620;464;532;0;0;19616
2022-10-05 00:30;18329;410;530;0;0;19269
2022-10-05 01:30;19000;445;530;0;0;19975
2022-10-05 02:30;18454;394;530;0;0;19378
2022-10-05 03:30;18195;249;530;0;0;18974
2022-10-05 04:30;18748;148;528;0;0;19424
2022-10-05 05:30;20928;64;529;0;0;21521
2022-10-05 06:30;22026;14;527;0;0;22567
2022-10-05 07:30;23006;11;525;0;0;23542
2022-10-05 08:30;22064;-5;526;3;26;22614
2022-10-05 09:30;21691;2;526;5;0;22224
2022-10-05 10:30;21540;25;525;7;0;22097
2022-10-05 11:30;21471;40;523;8;0;22042
2022-10-05 12:30;21546;55;498;8;0;22107
2022-10-05 13:30;21231;50;497;8;0;21786
2022-10-05 14:30;20734;54;497;8;0;21293
2022-10-05 15:30;20645;53;496;6;0;21200
2022-10-05 16:30;20962;79;492;4;0;21537
2022-10-05 17:30;21561;75;493;1;0;22130
2022-10-05 18:30;21657;156;501;0;0;22314
2022-10-05 19:30;22056;292;510;0;0;22858
2022-10-05 20:30;21804;532;506;0;0;22842
2022-10-05 21:30;21026;540;505;0;0;22071
2022-10-05 22:30;19925;692;507;0;0;21124
2022-10-05 23:30;19166;860;505;0;0;20531
2022-10-06 00:30;18591;1083;507;0;0;20181
2022-10-06 01:30;17892;1259;506;0;0;19657
2022-10-06 02:30;17008;1294;505;0;0;18807
2022-10-06 03:30;16793;1282;505;0;0;18580
2022-10-06 04:30;17579;1164;505;0;0;19248
2022-10-06 05:30;19241;1036;504;0;0;20781
2022-10-06 06:30;21541;895;504;0;0;22940
2022-10-06 07:30;22456;746;504;0;0;23706
2022-10-06 08:30;22292;540;500;2;0;23334
2022-10-06 09:30;22335;199;499;5;0;23038
2022-10-06 10:30;22414;127;499;7;0;23047
2022-10-06 11:30;21881;110;498;8;0;22497
2022-10-06 12:30;21805;148;516;7;0;22476
2022-10-06 13:30;21904;201;515;7;0;22627
2022-10-06 14:30;21838;240;519;7;0;22604
2022-10-06 15:30;22141;293;517;5;27;22983
2022-10-06 16:30;21858;280;518;1;68;22725
2022-10-06 17:30;22027;286;515;1;0;22829
2022-10-06 18:30;22203;514;521;0;0;23238
2022-10-06 19:30;22748;718;527;0;0;23993
2022-10-06 20:30;22392;884;528;0;0;23804
2022-10-06 21:30;21584;1010;528;0;0;23122
2022-10-06 22:30;20469;983;526;0;0;21978
2022-10-06 23:30;19162;1081;525;0;0;20768
2022-10-07 00:30;17701;1149;527;0;0;19377
2022-10-07 01:30;17243;1205;526;0;0;18974
2022-10-07 02:30;16950;1234;525;0;0;18709
2022-10-07 03:30;16456;1079;525;0;0;18060
2022-10-07 04:30;16598;1015;528;0;0;18141
2022-10-07 05:30;18536;824;528;0;0;19888
2022-10-07 06:30;20170;956;528;0;0;21654
2022-10-07 07:30;21239;1124;528;0;0;22891
2022-10-07 08:30;21667;984;522;1;0;23174
2022-10-07 09:30;21514;1082;521;1;0;23118
2022-10-07 10:30;21756;927;518;1;0;23202
2022-10-07 11:30;22303;891;520;1;0;23715
2022-10-07 12:30;22613;876;522;0;0;24011
2022-10-07 13:30;22554;791;484;4;0;23833
2022-10-07 14:30;22144;770;485;4;0;23403
2022-10-07 15:30;21831;1061;483;3;0;23378
2022-10-07 16:30;21569;1298;480;3;0;23350
2022-10-07 17:30;22606;1430;485;1;0;24522
2022-10-07 18:30;22955;1470;489;0;0;24914
2022-10-07 19:30;22595;1817;492;0;0;24904
2022-10-07 20:30;22049;1741;492;0;0;24282
2022-10-07 21:30;20924;1998;493;0;0;23415
2022-10-07 22:30;20635;1982;494;0;0;23111
2022-10-07 23:30;19580;2102;493;0;0;22175
2022-10-08 00:30;19083;2148;497;0;0;21728
2022-10-08 01:30;18639;2068;494;0;0;21201
2022-10-08 02:30;18351;1927;492;0;0;20770
2022-10-08 03:30;18526;1767;490;0;0;20783
2022-10-08 04:30;18817;1815;491;0;0;21123
2022-10-08 05:30;19603;1810;489;0;0;21902
2022-10-08 06:30;20750;1788;490;0;0;23028
2022-10-08 07:30;20932;1887;493;0;0;23312
2022-10-08 08:30;21497;1998;490;0;0;23985
2022-10-08 09:30;22133;1993;486;1;0;24613
2022-10-08 10:30;21527;2143;481;2;0;24153
2022-10-08 11:30;21582;2062;481;6;0;24131
2022-10-08 12:30;21461;1953;474;3;0;23891
2022-10-08 13:30;20966;1856;478;2;0;23302
2022-10-08 14:30;20952;1833;477;3;0;23265
2022-10-08 15:30;20096;1683;476;2;0;22257
2022-10-08 16:30;20302;1766;474;3;0;22545
2022-10-08 17:30;20945;1521;474;1;0;22941
2022-10-08 18:30;21431;1620;480;0;0;23531
2022-10-08 19:30;21105;1710;485;0;0;23300
2022-10-08 20:30;20813;1763;481;0;0;23057
2022-10-08 21:30;20412;1771;481;0;0;22664
2022-10-08 22:30;19444;1778;481;0;0;21703
2022-10-08 23:30;18927;1757;483;0;0;21167
2022-10-09 00:30;18480;1665;482;0;0;20627
2022-10-09 01:30;18736;1617;481;0;0;20834
2022-10-09 02:30;18093;1560;480;0;0;20133
2022-10-09 03:30;18202;1573;478;0;0;20253
2022-10-09 04:30;18333;1427;477;0;0;20237
2022-10-09 05:30;18749;1424;476;0;0;20649
2022-10-09 06:30;19574;1547;474;0;0;21595
2022-10-09 07:30;20247;1455;476;0;0;22178
2022-10-09 08:30;20668;1382;477;0;0;22527
2022-10-09 09:30;21286;1471;475;0;0;23232
2022-10-09 10:30;21098;1608;473;0;0;23179
2022-10-09 11:30;20886;1550;470;1;0;22907
2022-10-09 12:30;20679;1647;473;4;0;22803
2022-10-09 13:30;20189;1638;470;6;0;22303
2022-10-09 14:30;19568;1860;469;8;0;21905
2022-10-09 15:30;19884;1933;470;6;0;22293
2022-10-09 16:30;20747;1812;468;5;0;23032
2022-10-09 17:30;20608;1667;470;2;0;22747
2022-10-09 18:30;20964;2170;471;0;0;23605
2022-10-09 19:30;21730;2362;477;0;0;24569
2022-10-09 20:30;21791;1847;476;0;0;24114
2022-10-09 21:30;21283;2225;477;0;0;23985
2022-10-09 22:30;20836;2097;476;0;0;23409
2022-10-09 23:30;20508;1972;477;0;0;22957
2022-10-10 00:30;20001;1737;476;0;0;22214
2022-10-10 01:30;20024;1668;477;0;0;22169
2022-10-10 02:30;20059;1525;476;0;0;22060
2022-10-10 03:30;19806;1452;477;0;0;21735
2022-10-10 04:30;20593;1352;479;0;0;22424
2022-10-10 05:30;20631;1260;476;0;0;22367
2022-10-10 06:30;22290;1105;477;0;0;23872
2022-10-10 07:30;22178;1059;476;0;0;23713
2022-10-10 08:30;22941;911;472;1;0;24325
2022-10-10 09:30;23224;903;475;4;0;24606
2022-10-10 10:30;23014;1045;475;5;0;24539
2022-10-10 11:30;22729;920;476;7;0;24132
2022-10-10 12:30;22110;987;473;7;0;23577
2022-10-10 13:30;21098;1184;514;8;0;22804
2022-10-10 14:30;20559;1278;516;8;0;22361
2022-10-10 15:30;21065;1135;517;2;0;22719
2022-10-10 16:30;21331;1114;516;1;0;22962
2022-10-10 17:30;22477;1205;517;1;0;24200
2022-10-10 18:30;22561;1487;519;0;0;24567
2022-10-10 19:30;22483;1943;523;0;0;24949
2022-10-10 20:30;22543;2083;526;0;0;25152
2022-10-10 21:30;21245;2152;523;0;0;23920
2022-10-10 22:30;20875;2194;524;0;0;23593
2022-10-10 23:30;20068;2088;527;0;0;22683
2022-10-11 00:30;19544;2063;525;0;0;22132
2022-10-11 01:30;18861;1908;526;0;0;21295
2022-10-11 02:30;18641;1894;524;0;0;21059
2022-10-11 03:30;18587;1803;525;0;0;20915
2022-10-11 04:30;19267;1759;528;0;0;21554
2022-10-11 05:30;20382;1944;526;0;0;22852
2022-10-11 06:30;22980;2151;526;0;0;25657
2022-10-11 07:30;23385;2244;526;0;0;26155
2022-10-11 08:30;22071;2032;524;2;0;24629
2022-10-11 09:30;21873;1898;527;5;0;24303
2022-10-11 10:30;21377;1948;524;7;0;23856
2022-10-11 11:30;20958;2054;523;8;0;23543
2022-10-11 12:30;19974;2228;532;8;0;22742
2022-10-11 13:30;19397;2091;535;8;0;22031
2022-10-11 14:30;19178;2056;534;8;0;21776
2022-10-11 15:30;18718;2159;536;6;0;21419
2022-10-11 16:30;20328;2093;535;4;0;22960
2022-10-11 17:30;21975;2036;533;1;0;24545
2022-10-11 18:30;22058;2168;532;0;0;24758
2022-10-11 19:30;22255;2335;535;0;0;25125
2022-10-11 20:30;21294;2276;538;0;0;24108
2022-10-11 21:30;19777;2309;537;0;0;22623
2022-10-11 22:30;19513;2223;531;0;0;22267
2022-10-11 23:30;17955;2058;534;0;0;20547
2022-10-12 00:30;16795;1954;535;0;0;19284
2022-10-12 01:30;16351;1852;534;0;0;18737
2022-10-12 02:30;16333;1832;531;0;0;18696
2022-10-12 03:30;16522;1691;530;0;0;18743
2022-10-12 04:30;17034;1462;529;0;0;19025
2022-10-12 05:30;18882;1309;527;0;0;20718
2022-10-12 06:30;21677;1084;530;0;0;23291
2022-10-12 07:30;22459;987;528;0;0;23974
2022-10-12 08:30;22398;892;527;1;0;23818
2022-10-12 09:30;22221;640;524;5;0;23390
2022-10-12 10:30;21840;616;521;3;0;22980
2022-10-12 11:30;21883;618;519;4;0;23024
2022-10-12 12:30;21679;681;471;2;0;22833
2022-10-12 13:30;21296;821;472;4;0;22593
2022-10-12 14:30;20830;767;470;5;0;22072
2022-10-12 15:30;20968;736;470;2;0;22176
2022-10-12 16:30;21410;641;468;1;0;22520
2022-10-12 17:30;22241;799;468;0;0;23508
2022-10-12 18:30;22611;960;476;0;0;24047
2022-10-12 19:30;22189;1225;478;0;0;23892
2022-10-12 20:30;21339;1246;480;0;0;23065
2022-10-12 21:30;20498;1068;480;0;0;22046
2022-10-12 22:30;19550;1085;477;0;0;21112
2022-10-12 23:30;18030;1220;480;0;0;19730
2022-10-13 00:30;17590;1166;482;0;0;19238
2022-10-13 01:30;17327;1327;481;0;0;19135
2022-10-13 02:30;16640;1390;481;0;0;18511
2022-10-13 03:30;17075;1323;481;0;0;18879
2022-10-13 04:30;16588;1391;480;0;0;18459
2022-10-13 05:30;18198;1501;481;0;0;20180
2022-10-13 06:30;20003;1634;482;0;0;22119
2022-10-13 07:30;21615;1525;477;0;0;23617
2022-10-13 08:30;21441;1662;475;1;0;23579
2022-10-13 09:30;20986;1809;472;2;0;23269
2022-10-13 10:30;20846;1998;471;1;0;23316
2022-10-13 11:30;20778;2156;470;0;0;23404
2022-10-13 12:30;20780;2296;485;0;0;23561
2022-10-13 13:30;20602;2376;481;0;0;23459
2022-10-13 14:30;20177;2380;486;0;0;23043
2022-10-13 15:30;20118;2357;481;0;0;22956
2022-10-13 16:30;20854;2426;477;0;0;23757
2022-10-13 17:30;21597;2550;484;0;0;24631
2022-10-13 18:30;21819;2610;490;0;0;24919
2022-10-13 19:30;21329;2661;494;0;0;24484
2022-10-13 20:30;20524;2355;498;0;0;23377
2022-10-13 21:30;19671;2683;496;0;0;22850
2022-10-13 22:30;19003;2600;496;0;0;22099
2022-10-13 23:30;18025;2739;495;0;0;21259
2022-10-14 00:30;17163;2743;494;0;0;20400
2022-10-14 01:30;16487;2772;492;0;0;19751
2022-10-14 02:30;15749;2728;494;0;0;18971
2022-10-14 03:30;15654;2526;495;0;0;18675
2022-10-14 04:30;16290;2401;494;0;0;19185
2022-10-14 05:30;17722;2441;495;0;0;20658
2022-10-14 06:30;19586;2169;493;0;0;22248
2022-10-14 07:30;21345;2171;496;0;0;24012
2022-10-14 08:30;22158;1776;490;0;0;24424
2022-10-14 09:30;21933;1541;489;1;0;23964
2022-10-14 10:30;21891;1402;491;2;0;23786
2022-10-14 11:30;21683;1434;492;2;0;23611
2022-10-14 12:30;21241;1675;485;3;0;23404
2022-10-14 13:30;20951;1580;480;3;0;23014
2022-10-14 14:30;20321;1662;482;3;0;22468
2022-10-14 15:30;20252;1815;485;6;0;22558
2022-10-14 16:30;20759;1502;484;4;0;22749
2022-10-14 17:30;21282;1616;486;1;0;23385
2022-10-14 18:30;21731;1551;488;0;0;23770
2022-10-14 19:30;21646;1476;490;0;0;23612
2022-10-14 20:30;20669;1511;487;0;0;22667
2022-10-14 21:30;20061;1560;491;0;0;22112
2022-10-14 22:30;19341;1576;492;0;0;21409
2022-10-14 23:30;18470;1550;491;0;0;20511
2022-10-15 00:30;16874;1646;491;0;0;19011
2022-10-15 01:30;16179;1534;487;0;0;18200
2022-10-15 02:30;15727;1513;487;0;0;17727
2022-10-15 03:30;15809;1587;489;0;0;17885
2022-10-15 04:30;16119;1581;488;0;0;18188
2022-10-15 05:30;16533;1718;489;0;0;18740
2022-10-15 06:30;17665;1671;490;0;0;19826
2022-10-15 07:30;18945;1318;487;0;0;20750
2022-10-15 08:30;20052;1343;487;1;0;21883
2022-10-15 09:30;21078;1378;486;2;0;22944
2022-10-15 10:30;20549;1351;485;5;0;22390
2022-10-15 11:30;19756;1373;486;7;0;21622
2022-10-15 12:30;19245;1412;535;6;0;21198
2022-10-15 13:30;18406;1737;537;8;0;20688
2022-10-15 14:30;18016;1607;538;7;0;20168
2022-10-15 15:30;18558;1451;538;2;0;20549
2022-10-15 16:30;19205;1487;536;3;0;21231
2022-10-15 17:30;20059;1476;537;0;0;22072
2022-10-15 18:30;21095;1637;536;0;0;23268
2022-10-15 19:30;20618;1574;537;0;0;22729
2022-10-15 20:30;19817;1615;540;0;0;21972
2022-10-15 21:30;19082;1627;538;0;0;21247
2022-10-15 22:30;18616;1582;540;0;0;20738
2022-10-15 23:30;17555;1541;540;0;0;19636
2022-10-16 00:30;17318;1418;539;0;0;19275
2022-10-16 01:30;16477;1284;539;0;0;18300
2022-10-16 02:30;16754;1193;539;0;0;18486
2022-10-16 03:30;17222;971;536;0;0;18729
2022-10-16 04:30;17345;865;537;0;0;18747
2022-10-16 05:30;18382;823;540;0;0;19745
2022-10-16 06:30;19569;705;541;0;0;20815
2022-10-16 07:30;20513;580;541;0;0;21634
2022-10-16 08:30;21585;389;538;2;0;22514
2022-10-16 09:30;21853;237;537;4;0;22631
2022-10-16 10:30;21284;196;537;6;0;22023
2022-10-16 11:30;21456;146;538;5;0;22145
2022-10-16 12:30;21049;175;586;7;0;21817
2022-10-16 13:30;20451;173;580;8;0;21212
2022-10-16 14:30;20294;142;582;7;0;21025
2022-10-16 15:30;20948;117;581;2;0;21648
2022-10-16 16:30;21562;76;581;1;0;22220
2022-10-16 17:30;22799;93;582;1;0;23475
2022-10-16 18:30;23189;150;568;0;0;23907
2022-10-16 19:30;23120;153;572;0;0;23845
2022-10-16 20:30;22596;173;573;0;0;23342
2022-10-16 21:30;21226;204;575;0;0;22005
2022-10-16 22:30;20839;174;574;0;0;21587
2022-10-16 23:30;20052;169;573;0;0;20794
2022-10-17 00:30;18542;182;573;0;0;19297
2022-10-17 01:30;18244;225;574;0;0;19043
2022-10-17 02:30;17764;257;572;0;0;18593
2022-10-17 03:30;17394;233;573;0;0;18200
2022-10-17 04:30;17425;252;574;0;0;18251
2022-10-17 05:30;19159;311;574;0;0;20044
2022-10-17 06:30;20798;310;574;0;0;21682
2022-10-17 07:30;23233;420;575;0;0;24228
2022-10-17 08:30;23391;457;574;2;0;24424
2022-10-17 09:30;22758;397;576;2;0;23733
2022-10-17 10:30;22599;284;576;1;0;23460
2022-10-17 11:30;22693;216;580;4;0;23493
2022-10-17 12:30;22070;260;578;3;0;22911
2022-10-17 13:30;22057;240;637;2;0;22936
2022-10-17 14:30;21886;243;641;1;0;22771
2022-10-17 15:30;22040;327;639;0;0;23006
2022-10-17 16:30;22274;487;640;0;0;23401
2022-10-17 17:30;23209;569;639;0;0;24417
2022-10-17 18:30;23500;719;645;0;0;24864
2022-10-17 19:30;22569;1009;649;0;0;24227
2022-10-17 20:30;21799;1120;653;0;0;23572
2022-10-17 21:30;20216;1143;647;0;0;22006
2022-10-17 22:30;19485;1270;651;0;0;21406
2022-10-17 23:30;18538;1293;651;0;0;20482
2022-10-18 00:30;17809;1415;652;0;0;19876
2022-10-18 01:30;16832;1378;652;0;0;18862
2022-10-18 02:30;16703;1336;652;0;0;18691
2022-10-18 03:30;15987;1431;651;0;0;18069
2022-10-18 04:30;16289;1666;651;0;0;18606
2022-10-18 05:30;17976;1845;652;0;0;20473
2022-10-18 06:30;20264;2070;653;0;0;22987
2022-10-18 07:30;21661;1795;626;0;0;24082
2022-10-18 08:30;21490;2038;625;0;0;24153
2022-10-18 09:30;21417;1950;624;3;0;23994
2022-10-18 10:30;20772;1914;621;2;0;23309
2022-10-18 11:30;20408;1951;623;3;0;22985
2022-10-18 12:30;19987;1831;638;6;0;22462
2022-10-18 13:30;20084;1805;640;0;0;22529
2022-10-18 14:30;19961;1882;641;1;0;22485
2022-10-18 15:30;20035;1897;637;5;0;22574
2022-10-18 16:30;20680;1821;636;3;0;23140
2022-10-18 17:30;21891;1670;637;1;0;24199
2022-10-18 18:30;22481;1623;643;0;0;24747
2022-10-18 19:30;21848;1757;647;0;0;24252
2022-10-18 20:30;21198;2068;646;0;0;23912
2022-10-18 21:30;20482;1632;645;0;0;22759
2022-10-18 22:30;19798;1553;644;0;0;21995
2022-10-18 23:30;19164;1368;653;0;0;21185
2022-10-19 00:30;18334;1333;658;0;0;20325
2022-10-19 01:30;17539;1445;667;0;0;19651
2022-10-19 02:30;17237;1452;665;0;0;19354
2022-10-19 03:30;17162;1463;665;0;0;19290
2022-10-19 04:30;18126;1437;665;0;0;20228
2022-10-19 05:30;19620;1438;664;0;0;21722
2022-10-19 06:30;21479;1552;663;0;0;23694
2022-10-19 07:30;22773;1500;667;0;0;24940
2022-10-19 08:30;22686;1506;669;2;0;24863
2022-10-19 09:30;22357;1409;669;5;0;24440
2022-10-19 10:30;21569;1368;663;6;0;23606
2022-10-19 11:30;21785;1338;661;6;0;23790
2022-10-19 12:30;20770;1361;639;3;0;22773
2022-10-19 13:30;20669;1778;641;4;0;23092
2022-10-19 14:30;20493;1682;641;7;0;22823
2022-10-19 15:30;20683;1512;637;1;0;22833
2022-10-19 16:30;21663;1566;638;1;0;23868
2022-10-19 17:30;23539;1119;640;0;0;25298
2022-10-19 18:30;23526;1405;641;0;0;25572
2022-10-19 19:30;23111;1446;640;0;0;25197
2022-10-19 20:30;22966;1378;639;0;0;24983
2022-10-19 21:30;22061;1417;641;0;0;24119
2022-10-19 22:30;20984;1333;640;0;0;22957
2022-10-19 23:30;19881;1096;642;0;0;21619
2022-10-20 00:30;18637;1082;642;0;0;20361
2022-10-20 01:30;18161;1267;642;0;0;20070
2022-10-20 02:30;17368;1399;637;0;0;19404
2022-10-20 03:30;16891;1460;637;0;0;18988
2022-10-20 04:30;17394;1418;637;0;0;19449
2022-10-20 05:30;18856;1458;638;0;0;20952
2022-10-20 06:30;21650;1558;635;0;0;23843
2022-10-20 07:30;22599;1653;633;0;0;24885
2022-10-20 08:30;22693;1489;628;0;0;24810
2022-10-20 09:30;21882;1472;628;1;0;23983
2022-10-20 10:30;21895;1664;625;1;0;24185
2022-10-20 11:30;22171;1766;625;1;0;24563
2022-10-20 12:30;20500;1734;626;2;0;22862
2022-10-20 13:30;20119;1630;623;1;0;22373
2022-10-20 14:30;20661;1517;623;3;0;22804
2022-10-20 15:30;21646;1575;626;0;0;23847
2022-10-20 16:30;23277;1394;628;1;0;25300
2022-10-20 17:30;24285;1538;632;0;0;26455
2022-10-20 18:30;24345;1621;636;0;0;26602
2022-10-20 19:30;24066;1750;637;0;0;26453
2022-10-20 20:30;23172;1939;640;0;0;25751
2022-10-20 21:30;22434;1847;650;0;0;24931
2022-10-20 22:30;20822;2092;654;0;0;23568
2022-10-20 23:30;19163;2001;657;0;0;21821
2022-10-21 00:30;18888;2025;659;0;0;21572
2022-10-21 01:30;17626;2143;657;0;0;20426
2022-10-21 02:30;16582;2031;658;0;0;19271
2022-10-21 03:30;16086;2040;657;0;0;18783
2022-10-21 04:30;16323;2242;653;0;0;19218
2022-10-21 05:30;18104;2367;654;0;0;21125
2022-10-21 06:30;20408;2467;655;0;0;23530
2022-10-21 07:30;22189;2392;656;0;0;25237
2022-10-21 08:30;21637;2113;658;1;0;24409
2022-10-21 09:30;20991;1976;655;1;0;23623
2022-10-21 10:30;20242;2006;654;5;0;22907
2022-10-21 11:30;18916;2058;657;4;0;21635
2022-10-21 12:30;17969;2033;645;8;0;20655
2022-10-21 13:30;17731;2095;644;8;0;20478
2022-10-21 14:30;17706;1962;644;7;0;20319
2022-10-21 15:30;17942;1737;644;5;0;20328
2022-10-21 16:30;19125;1554;643;1;0;21323
2022-10-21 17:30;20605;1404;645;1;0;22655
2022-10-21 18:30;20763;2083;648;0;0;23494
2022-10-21 19:30;19746;2447;656;0;0;22849
2022-10-21 20:30;18786;2580;656;0;0;22022
2022-10-21 21:30;17335;2873;656;0;0;20864
2022-10-21 22:30;16035;2894;661;0;0;19590
2022-10-21 23:30;15069;2900;655;0;0;18624
2022-10-22 00:30;14883;2710;655;0;0;18248
2022-10-22 01:30;14527;2317;656;0;0;17500
2022-10-22 02:30;14046;2602;656;0;0;17304
2022-10-22 03:30;14168;2629;656;0;0;17453
2022-10-22 04:30;14498;2679;657;0;0;17834
2022-10-22 05:30;15055;2780;657;0;0;18492
2022-10-22 06:30;16015;2927;656;0;0;19598
2022-10-22 07:30;16917;2492;655;0;0;20064
2022-10-22 08:30;17400;2691;657;1;0;20749
2022-10-22 09:30;17911;2303;656;4;0;20874
2022-10-22 10:30;17398;2064;653;6;0;20121
2022-10-22 11:30;16797;2027;650;7;0;19481
2022-10-22 12:30;15674;2112;659;8;0;18453
2022-10-22 13:30;15031;2165;656;8;0;17860
2022-10-22 14:30;14257;2281;658;5;0;17201
2022-10-22 15:30;14734;2264;656;5;0;17659
2022-10-22 16:30;16640;2241;657;3;0;19541
2022-10-22 17:30;16891;2401;658;0;0;19950
2022-10-22 18:30;17621;2611;661;0;0;20893
2022-10-22 19:30;17064;2391;662;0;0;20117
2022-10-22 20:30;16032;2649;664;0;0;19345
2022-10-22 21:30;15052;2633;667;0;0;18352
2022-10-22 22:30;14139;2587;667;0;0;17393
2022-10-22 23:30;13367;2425;666;0;0;16458
2022-10-23 00:30;13889;2356;665;0;0;16910
2022-10-23 01:30;13673;2103;667;0;0;16443
2022-10-23 02:30;13777;1878;666;0;0;16321
2022-10-23 03:30;14254;1719;668;0;0;16641
2022-10-23 04:30;14616;1481;667;0;0;16764
2022-10-23 05:30;15398;1266;667;0;0;17331
2022-10-23 06:30;16882;1030;667;0;0;18579
2022-10-23 07:30;18046;1044;671;0;0;19761
2022-10-23 08:30;19439;746;667;1;0;20853
2022-10-23 09:30;19959;466;668;4;0;21097
2022-10-23 10:30;19699;365;666;5;0;20735
2022-10-23 11:30;19829;317;664;7;0;20817
2022-10-23 12:30;19457;383;649;7;0;20496
2022-10-23 13:30;18891;447;655;6;0;19999
2022-10-23 14:30;18342;471;652;4;0;19469
2022-10-23 15:30;18914;420;650;3;0;19987
2022-10-23 16:30;19772;316;648;2;0;20738
2022-10-23 17:30;21023;505;647;0;0;22175
2022-10-23 18:30;21888;618;652;0;0;23158
2022-10-23 19:30;21246;693;656;0;0;22595
2022-10-23 20:30;19652;756;657;0;0;21065
2022-10-23 21:30;18673;686;660;0;0;20019
2022-10-23 22:30;17339;654;661;0;0;18654
2022-10-23 23:30;16241;524;661;0;0;17426
2022-10-24 00:30;16295;389;660;0;0;17344
2022-10-24 01:30;15802;214;660;0;0;16676
2022-10-24 02:30;15897;134;660;0;0;16691
2022-10-24 03:30;15690;93;659;0;0;16442
2022-10-24 04:30;16141;148;661;0;0;16950
2022-10-24 05:30;17692;152;661;0;0;18505
2022-10-24 06:30;20087;245;664;0;0;20996
2022-10-24 07:30;22335;298;664;0;0;23297
2022-10-24 08:30;22429;492;663;0;0;23584
2022-10-24 09:30;21647;615;661;1;0;22924
2022-10-24 10:30;20995;545;662;2;0;22204
2022-10-24 11:30;20600;501;661;2;0;21764
2022-10-24 12:30;20696;493;659;4;0;21852
2022-10-24 13:30;20001;449;650;2;0;21102
2022-10-24 14:30;19648;345;649;2;0;20644
2022-10-24 15:30;20028;314;647;5;0;20994
2022-10-24 16:30;20735;399;647;3;0;21784
2022-10-24 17:30;22236;417;648;0;0;23301
2022-10-24 18:30;22794;626;647;0;0;24067
2022-10-24 19:30;22369;636;652;0;0;23657
2022-10-24 20:30;21045;722;653;0;0;22420
2022-10-24 21:30;19206;652;653;0;0;20511
2022-10-24 22:30;18019;559;654;0;0;19232
2022-10-24 23:30;17246;400;652;0;0;18298
2022-10-25 00:30;17115;356;652;0;0;18123
2022-10-25 01:30;15702;411;649;0;0;16762
2022-10-25 02:30;15278;459;652;0;0;16389
2022-10-25 03:30;15084;363;651;0;0;16098
2022-10-25 04:30;15786;277;650;0;0;16713
2022-10-25 05:30;16914;334;649;0;0;17897
2022-10-25 06:30;19354;338;650;0;0;20342
2022-10-25 07:30;20929;387;651;0;0;21967
2022-10-25 08:30;21242;423;643;0;0;22308
2022-10-25 09:30;21380;341;638;2;0;22361
2022-10-25 10:30;21378;284;632;4;0;22298
2022-10-25 11:30;21181;318;626;4;0;22129
2022-10-25 12:30;20934;355;628;6;0;21923
2022-10-25 13:30;21173;368;578;8;0;22127
2022-10-25 14:30;20674;456;572;7;0;21709
2022-10-25 15:30;20489;560;569;5;0;21623
2022-10-25 16:30;20919;726;569;3;0;22217
2022-10-25 17:30;21330;883;597;0;0;22810
2022-10-25 18:30;21851;1047;599;0;0;23497
2022-10-25 19:30;21249;1059;601;0;0;22909
2022-10-25 20:30;19856;1333;598;0;0;21787
2022-10-25 21:30;18606;1409;597;0;0;20612
2022-10-25 22:30;17736;1409;596;0;0;19741
2022-10-25 23:30;16074;1560;597;0;0;18231
2022-10-26 00:30;14575;1529;598;0;0;16702
2022-10-26 01:30;13990;1551;598;0;0;16139
2022-10-26 02:30;13677;1430;595;0;0;15702
2022-10-26 03:30;13568;1413;595;0;0;15576
2022-10-26 04:30;14150;1353;594;0;0;16097
2022-10-26 05:30;16020;1319;596;0;0;17935
2022-10-26 06:30;18767;1322;596;0;0;20685
2022-10-26 07:30;20592;1287;596;0;0;22475
2022-10-26 08:30;21365;1178;592;2;0;23137
2022-10-26 09:30;21395;1089;590;3;4;23081
2022-10-26 10:30;21197;1141;592;5;0;22935
2022-10-26 11:30;21194;1193;592;8;0;22987
2022-10-26 12:30;21284;1137;590;8;0;23019
2022-10-26 13:30;21062;1242;615;6;0;22925
2022-10-26 14:30;20903;1197;610;4;0;22714
2022-10-26 15:30;20356;1180;612;2;0;22150
2022-10-26 16:30;20630;1248;615;3;0;22496
2022-10-26 17:30;21059;1516;616;0;0;23191
2022-10-26 18:30;21604;1717;620;0;0;23941
2022-10-26 19:30;21194;1725;622;0;0;23541
2022-10-26 20:30;20439;1703;622;0;0;22764
2022-10-26 21:30;18986;1590;624;0;0;21200
2022-10-26 22:30;17727;1606;625;0;0;19958
2022-10-26 23:30;16579;1452;624;0;0;18655
2022-10-27 00:30;14807;1641;624;0;0;17072
2022-10-27 01:30;14457;1696;624;0;0;16777
2022-10-27 02:30;14026;1714;625;0;0;16365
2022-10-27 03:30;13491;1670;622;0;0;15783
2022-10-27 04:30;14262;1952;621;0;0;16835
2022-10-27 05:30;15651;2184;622;0;0;18457
2022-10-27 06:30;17757;2617;623;0;0;20997
2022-10-27 07:30;19864;2670;622;0;0;23156
2022-10-27 08:30;20464;2642;619;1;0;23726
2022-10-27 09:30;19770;2724;617;4;0;23115
2022-10-27 10:30;19133;2455;620;3;0;22211
2022-10-27 11:30;18284;2523;613;5;0;21425
2022-10-27 12:30;18148;2504;580;7;0;21239
2022-10-27 13:30;17718;2526;579;6;0;20829
2022-10-27 14:30;17537;2523;581;7;0;20648
2022-10-27 15:30;18051;2550;581;5;0;21187
2022-10-27 16:30;19563;2464;576;3;0;22606
2022-10-27 17:30;21299;2520;578;0;0;24397
2022-10-27 18:30;22520;2438;579;0;0;25537
2022-10-27 19:30;22302;2569;582;0;0;25453
2022-10-27 20:30;21804;2475;583;0;0;24862
2022-10-27 21:30;21162;2429;584;0;0;24175
2022-10-27 22:30;20132;2359;584;0;0;23075
2022-10-27 23:30;18967;2347;584;0;0;21898
2022-10-28 00:30;18265;2629;581;0;0;21475
2022-10-28 01:30;17132;2441;580;0;0;20153
2022-10-28 02:30;16836;2105;580;0;0;19521
2022-10-28 03:30;16878;2430;576;0;0;19884
2022-10-28 04:30;18033;2258;578;0;0;20869
2022-10-28 05:30;20349;2067;579;0;0;22995
2022-10-28 06:30;23538;2054;582;0;0;26174
2022-10-28 07:30;25351;1889;583;0;0;27823
2022-10-28 08:30;25559;1671;583;2;0;27815
2022-10-28 09:30;24830;1453;581;4;0;26868
2022-10-28 10:30;24057;1103;579;6;0;25745
2022-10-28 11:30;23812;766;582;7;0;25167
2022-10-28 12:30;22893;599;583;8;0;24083
2022-10-28 13:30;22228;563;584;7;0;23382
2022-10-28 14:30;22160;541;585;6;0;23292
2022-10-28 15:30;21959;546;584;4;0;23093
2022-10-28 16:30;23140;614;585;3;0;24342
2022-10-28 17:30;24031;892;588;0;0;25511
2022-10-28 18:30;24425;1330;590;0;0;26345
2022-10-28 19:30;23770;1515;593;0;0;25878
2022-10-28 20:30;23483;1580;591;0;0;25654
2022-10-28 21:30;23051;1560;592;0;0;25203
2022-10-28 22:30;21873;1615;592;0;0;24080
2022-10-28 23:30;20506;1612;590;0;0;22708
2022-10-29 00:30;19336;1690;591;0;0;21617
2022-10-29 01:30;18871;1751;590;0;0;21212
2022-10-29 02:30;18670;1918;587;0;0;21175
2022-10-29 03:30;18525;2114;590;0;0;21229
2022-10-29 04:30;18559;2281;590;0;0;21430
2022-10-29 05:30;19362;2255;589;0;0;22206
2022-10-29 06:30;20876;2333;589;0;0;23798
2022-10-29 07:30;22293;2217;589;0;0;25099
2022-10-29 08:30;23279;2156;590;1;0;26026
2022-10-29 09:30;22924;1840;586;4;0;25354
2022-10-29 10:30;21934;1582;584;6;0;24106
2022-10-29 11:30;20543;1699;580;7;0;22829
2022-10-29 12:30;19092;1824;605;5;0;21526
2022-10-29 13:30;18011;1927;605;7;0;20550
2022-10-29 14:30;17571;2018;606;6;0;20201
2022-10-29 15:30;17403;2117;601;5;0;20126
2022-10-29 16:30;19115;2189;603;2;0;21909
2022-10-29 17:30;20825;2475;607;0;0;23907
2022-10-29 18:30;21232;2742;611;0;0;24585
2022-10-29 19:30;20646;2398;610;0;0;23654
2022-10-29 20:30;19538;2816;611;0;0;22965
2022-10-29 21:30;18295;2453;614;0;0;21362
2022-10-29 22:30;16909;2568;616;0;0;20093
2022-10-29 23:30;16067;2611;614;0;0;19292
2022-10-30 00:30;15493;2513;613;0;0;18619
2022-10-30 01:30;15297;2397;614;0;0;18308
2022-10-30 02:30;15062;2613;615;0;0;18290
2022-10-30 03:30;15890;2359;616;0;0;18865
2022-10-30 04:30;15904;1782;615;0;0;18301
2022-10-30 05:30;17247;1995;612;0;0;19854
2022-10-30 06:30;18426;1731;613;0;0;20770
2022-10-30 07:30;19852;1484;613;0;0;21949
2022-10-30 08:30;20560;1182;609;1;0;22352
2022-10-30 09:30;21036;810;614;4;0;22464
2022-10-30 10:30;19816;730;611;6;0;21163
2022-10-30 11:30;19246;626;609;8;0;20489
2022-10-30 12:30;18752;625;610;7;0;19994
2022-10-30 13:30;18895;678;607;6;0;20186
2022-10-30 14:30;18856;728;601;5;0;20190
2022-10-30 15:30;19638;758;599;4;0;20999
2022-10-30 16:30;20245;797;604;1;0;21647
2022-10-30 17:30;21746;1212;603;0;0;23561
2022-10-30 18:30;22313;1631;611;0;0;24555
2022-10-30 19:30;21310;1992;610;0;0;23912
2022-10-30 20:30;20174;2267;610;0;0;23051
2022-10-30 21:30;19015;2387;612;0;0;22014
2022-10-30 22:30;17562;2484;613;0;0;20659
2022-10-30 23:30;16456;2508;614;0;0;19578
2022-10-31 00:30;15453;2429;607;0;0;18489
2022-10-31 01:30;14565;2353;607;0;0;17525
2022-10-31 02:30;14916;2313;608;0;0;17837
2022-10-31 03:30;14736;2295;608;0;0;17639
2022-10-31 04:30;15976;2037;605;0;0;18618
2022-10-31 05:30;18329;1907;606;0;0;20842
2022-10-31 06:30;22259;1805;603;0;0;24667
2022-10-31 07:30;24308;1679;606;0;0;26593
2022-10-31 08:30;24503;1446;609;0;0;26558
2022-10-31 09:30;24372;1097;606;5;0;26080
2022-10-31 10:30;23920;769;601;4;0;25294
2022-10-31 11:30;23609;644;604;7;0;24864
2022-10-31 12:30;22974;424;598;6;0;24002
2022-10-31 13:30;22855;309;598;2;0;23764
2022-10-31 14:30;22733;225;598;2;0;23558
2022-10-31 15:30;23634;159;600;1;0;24394
2022-10-31 16:30;24390;70;602;2;0;25064
2022-10-31 17:30;24885;79;602;0;0;25566
2022-10-31 18:30;24861;91;603;0;0;25555
2022-10-31 19:30;24322;143;610;0;0;25075
2022-10-31 20:30;23323;340;608;0;0;24271
2022-10-31 21:30;21958;456;611;0;0;23025
2022-10-31 22:30;20117;789;616;0;0;21522
2022-10-31 23:30;18141;858;616;0;0;19615
2022-11-01 00:30;17033;1055;613;0;0;18701
2022-11-01 01:30;17027;1217;619;0;0;18863
2022-11-01 02:30;16756;1200;620;0;0;18576
2022-11-01 03:30;16207;1250;621;0;0;18078
2022-11-01 04:30;17029;1301;623;0;0;18953
2022-11-01 05:30;19096;1278;619;0;0;20993
2022-11-01 06:30;21388;1186;620;0;0;23194
2022-11-01 07:30;23443;1001;616;0;0;25060
2022-11-01 08:30;23838;865;613;0;0;25316
2022-11-01 09:30;23643;670;613;0;0;24926
2022-11-01 10:30;23920;452;610;0;0;24982
2022-11-01 11:30;24119;301;609;0;0;25029
2022-11-01 12:30;23227;300;589;1;0;24117
2022-11-01 13:30;23131;335;591;1;0;24058
2022-11-01 14:30;22356;400;594;1;0;23351
2022-11-01 15:30;22001;482;595;0;0;23078
2022-11-01 16:30;22660;653;596;0;0;23909
2022-11-01 17:30;23589;852;600;0;0;25041
2022-11-01 18:30;23562;1119;606;0;0;25287
2022-11-01 19:30;22545;1337;605;0;0;24487
2022-11-01 20:30;21913;1417;607;0;0;23937
2022-11-01 21:30;20757;1684;610;0;0;23051
2022-11-01 22:30;19451;1927;608;0;0;21986
2022-11-01 23:30;17271;2243;604;0;0;20118
2022-11-02 00:30;15479;2692;605;0;0;18776
2022-11-02 01:30;14698;2841;607;0;0;18146
2022-11-02 02:30;14416;2930;608;0;0;17954
2022-11-02 03:30;14221;3029;606;0;0;17856
2022-11-02 04:30;14998;2629;607;0;0;18234
2022-11-02 05:30;16871;2573;608;0;0;20052
2022-11-02 06:30;19263;2523;609;0;0;22395
2022-11-02 07:30;21815;2540;610;0;0;24965
2022-11-02 08:30;22027;2407;605;1;0;25040
2022-11-02 09:30;20664;2598;602;4;0;23868
2022-11-02 10:30;19512;2131;607;6;0;22256
2022-11-02 11:30;19096;1928;612;7;0;21643
2022-11-02 12:30;18784;1826;612;8;0;21230
2022-11-02 13:30;18282;1818;597;7;0;20704
2022-11-02 14:30;17525;1860;599;6;0;19990
2022-11-02 15:30;18433;1776;599;5;0;20813
2022-11-02 16:30;19451;1756;600;2;0;21809
2022-11-02 17:30;21427;1736;598;0;0;23761
2022-11-02 18:30;22591;2182;601;0;0;25374
2022-11-02 19:30;22558;1653;604;0;0;24815
2022-11-02 20:30;21822;1642;608;0;0;24072
2022-11-02 21:30;20875;1923;606;0;0;23404
2022-11-02 22:30;19384;1784;602;0;0;21770
2022-11-02 23:30;17707;1635;600;0;0;19942
2022-11-03 00:30;16977;1520;601;0;0;19098
2022-11-03 01:30;16360;1565;600;0;0;18525
2022-11-03 02:30;16251;1472;600;0;0;18323
2022-11-03 03:30;16326;1500;600;0;0;18426
2022-11-03 04:30;17148;1557;599;0;0;19304
2022-11-03 05:30;19074;1532;600;0;0;21206
2022-11-03 06:30;22508;1472;600;0;0;24580
2022-11-03 07:30;24737;1487;599;0;0;26823
2022-11-03 08:30;24507;1552;600;1;0;26660
2022-11-03 09:30;23394;1496;599;4;0;25493
2022-11-03 10:30;22125;1476;602;6;0;24209
2022-11-03 11:30;21145;1356;600;7;0;23108
2022-11-03 12:30;19838;1421;601;8;0;21868
2022-11-03 13:30;19306;1533;601;7;0;21447
2022-11-03 14:30;18415;1662;601;6;0;20684
2022-11-03 15:30;18992;1812;602;4;0;21410
2022-11-03 16:30;19736;2051;598;2;0;22387
2022-11-03 17:30;20646;2455;603;0;0;23704
2022-11-03 18:30;21399;2464;607;0;0;24470
2022-11-03 19:30;21056;2415;610;0;0;24081
2022-11-03 20:30;19756;2436;614;0;0;22806
2022-11-03 21:30;18258;2562;612;0;0;21432
2022-11-03 22:30;17050;2621;612;0;0;20283
2022-11-03 23:30;14825;2644;612;0;0;18081
2022-11-04 00:30;13242;2560;611;0;0;16413
2022-11-04 01:30;12916;2469;611;0;0;15996
2022-11-04 02:30;12753;2359;611;0;0;15723
2022-11-04 03:30;13169;2179;611;0;0;15959
2022-11-04 04:30;13649;2441;610;0;0;16700
2022-11-04 05:30;15432;2301;610;0;0;18343
2022-11-04 06:30;17908;2195;609;0;0;20712
2022-11-04 07:30;21017;2240;609;0;0;23866
2022-11-04 08:30;21489;2113;609;1;0;24212
2022-11-04 09:30;20624;1898;612;3;0;23137
2022-11-04 10:30;19240;1714;611;5;0;21570
2022-11-04 11:30;18658;1483;598;7;0;20746
2022-11-04 12:30;17903;1612;572;3;0;20090
2022-11-04 13:30;17700;1593;570;7;0;19870
2022-11-04 14:30;17403;1835;574;5;0;19817
2022-11-04 15:30;17657;1953;574;4;0;20188
2022-11-04 16:30;18046;2167;576;1;0;20790
2022-11-04 17:30;18820;2552;574;0;0;21946
2022-11-04 18:30;19009;2957;575;0;0;22541
2022-11-04 19:30;18046;2708;580;0;0;21334
2022-11-04 20:30;17097;2674;588;0;0;20359
2022-11-04 21:30;16190;2667;588;0;0;19445
2022-11-04 22:30;15145;2681;586;0;0;18412
2022-11-04 23:30;13173;2709;584;0;0;16466
2022-11-05 00:30;11557;3029;590;0;0;15176
2022-11-05 01:30;11491;2642;589;0;0;14722
2022-11-05 02:30;11447;3023;587;0;0;15057
2022-11-05 03:30;11467;2772;587;0;0;14826
2022-11-05 04:30;11597;2764;586;0;0;14947
2022-11-05 05:30;11730;2834;585;0;0;15149
2022-11-05 06:30;12641;2819;585;0;0;16045
2022-11-05 07:30;13112;2802;589;0;0;16503
2022-11-05 08:30;14263;2726;588;1;0;17578
2022-11-05 09:30;15285;2486;588;3;0;18362
2022-11-05 10:30;15689;2661;586;6;0;18942
2022-11-05 11:30;15420;2452;584;7;0;18463
2022-11-05 12:30;15308;2284;533;6;0;18131
2022-11-05 13:30;15081;2157;536;7;0;17781
2022-11-05 14:30;14602;2080;536;1;0;17219
2022-11-05 15:30;14556;2059;533;2;0;17150
2022-11-05 16:30;15807;1853;526;1;0;18187
2022-11-05 17:30;16952;1925;530;0;0;19407
2022-11-05 18:30;17910;2163;534;0;0;20607
2022-11-05 19:30;15956;2298;537;0;0;18791
2022-11-05 20:30;14465;2451;540;0;0;17456
2022-11-05 21:30;13579;2449;541;0;0;16569
2022-11-05 22:30;12726;2458;541;0;0;15725
2022-11-05 23:30;11708;2564;540;0;0;14812
2022-11-06 00:30;11573;2634;539;0;0;14746
2022-11-06 01:30;11792;2592;1074;0;0;15458
2022-11-06 01:30;11688;2576;1074;0;0;15338
2022-11-06 02:30;10806;2606;537;0;0;13949
2022-11-06 03:30;10714;2720;538;0;0;13972
2022-11-06 04:30;11371;2704;537;0;0;14612
2022-11-06 05:30;11588;2773;537;0;0;14898
2022-11-06 06:30;12188;2888;538;0;0;15614
2022-11-06 07:30;12843;2819;536;0;0;16198
2022-11-06 08:30;13964;2688;536;0;0;17188
2022-11-06 09:30;14567;2703;533;0;0;17803
2022-11-06 10:30;15050;2695;535;1;0;18281
2022-11-06 11:30;15417;2794;534;1;0;18746
2022-11-06 12:30;15945;2836;563;1;0;19345
2022-11-06 13:30;15627;2929;560;1;0;19117
2022-11-06 14:30;15567;2952;561;1;0;19081
2022-11-06 15:30;15832;2665;562;1;0;19060
2022-11-06 16:30;17021;2639;564;0;0;20224
2022-11-06 17:30;18767;2626;565;0;0;21958
2022-11-06 18:30;18024;2554;570;0;0;21148
2022-11-06 19:30;16773;2440;572;0;0;19785
2022-11-06 20:30;15933;2233;573;0;0;18739
2022-11-06 21:30;13886;2306;572;0;0;16764
2022-11-06 22:30;13148;2112;567;0;0;15827
2022-11-06 23:30;12048;1972;568;0;0;14588
2022-11-07 00:30;12152;1769;568;0;0;14489
2022-11-07 01:30;11899;1860;567;0;0;14326
2022-11-07 02:30;11728;1936;563;0;0;14227
2022-11-07 03:30;11541;2304;565;0;0;14410
2022-11-07 04:30;12058;2228;565;0;0;14851
2022-11-07 05:30;13288;2408;566;0;0;16262
2022-11-07 06:30;16231;2457;566;0;0;19254
2022-11-07 07:30;17763;2442;568;1;0;20774
2022-11-07 08:30;18053;2471;569;3;0;21096
2022-11-07 09:30;17545;2616;570;6;0;20737
2022-11-07 10:30;16933;2750;566;7;0;20256
2022-11-07 11:30;16720;2464;561;8;0;19753
2022-11-07 12:30;16519;2602;550;9;0;19680
2022-11-07 13:30;17115;2439;547;6;0;20107
2022-11-07 14:30;17140;2968;553;0;0;20661
2022-11-07 15:30;17514;3181;559;1;0;21255
2022-11-07 16:30;18762;2955;559;0;0;22276
2022-11-07 17:30;20527;2963;561;0;0;24051
2022-11-07 18:30;20368;2962;562;0;0;23892
2022-11-07 19:30;19515;2937;564;0;0;23016
2022-11-07 20:30;18505;2914;563;0;0;21982
2022-11-07 21:30;16621;2978;564;0;0;20163
2022-11-07 22:30;15544;2901;560;0;0;19005
2022-11-07 23:30;13855;2872;561;0;0;17288
2022-11-08 00:30;13801;2907;560;0;0;17268
2022-11-08 01:30;13609;2858;558;0;0;17025
2022-11-08 02:30;13719;2806;554;0;0;17079
2022-11-08 03:30;14099;2696;555;0;0;17350
2022-11-08 04:30;14767;2757;552;0;0;18076
2022-11-08 05:30;17214;2821;554;0;0;20589
2022-11-08 06:30;20362;2772;556;0;0;23690
2022-11-08 07:30;22208;2757;558;1;0;25524
2022-11-08 08:30;21538;2718;550;4;0;24810
2022-11-08 09:30;19948;2789;555;7;0;23299
2022-11-08 10:30;19215;2741;550;8;0;22514
2022-11-08 11:30;18592;2668;557;8;0;21825
2022-11-08 12:30;18057;2699;553;8;0;21317
2022-11-08 13:30;17682;2721;533;7;0;20943
2022-11-08 14:30;17927;2660;527;5;0;21119
2022-11-08 15:30;19713;2681;531;2;0;22927
2022-11-08 16:30;21792;2614;527;0;0;24933
2022-11-08 17:30;24210;2585;530;0;0;27325
2022-11-08 18:30;23834;2462;532;0;0;26828
2022-11-08 19:30;23320;2421;532;0;0;26273
2022-11-08 20:30;22718;2276;534;0;0;25528
2022-11-08 21:30;21359;2108;535;0;0;24002
2022-11-08 22:30;20021;2089;537;0;0;22647
2022-11-08 23:30;18189;2244;536;0;0;20969
2022-11-09 00:30;17481;2048;536;0;0;20065
2022-11-09 01:30;17498;1903;537;0;0;19938
2022-11-09 02:30;17921;1480;533;0;0;19934
2022-11-09 03:30;18401;1342;532;0;0;20275
2022-11-09 04:30;19690;1704;532;0;0;21926
2022-11-09 05:30;22551;1577;527;0;0;24655
2022-11-09 06:30;25246;1364;523;0;0;27133
2022-11-09 07:30;25933;1245;522;1;0;27701
2022-11-09 08:30;24699;1019;526;3;0;26247
2022-11-09 09:30;23863;823;526;6;0;25218
2022-11-09 10:30;22713;762;522;7;0;24004
2022-11-09 11:30;22145;668;520;8;0;23341
2022-11-09 12:30;21581;706;515;8;0;22810
2022-11-09 13:30;21781;646;515;6;0;22948
2022-11-09 14:30;21878;566;517;5;93;23059
2022-11-09 15:30;23914;697;514;1;0;25126
2022-11-09 16:30;24871;1085;515;0;0;26471
2022-11-09 17:30;25087;1676;515;0;0;27278
2022-11-09 18:30;23701;2050;515;0;0;26266
2022-11-09 19:30;21802;2513;521;0;0;24836
2022-11-09 20:30;20992;2352;521;0;0;23865
2022-11-09 21:30;19085;2356;518;0;0;21959
2022-11-09 22:30;16739;2565;517;0;0;19821
2022-11-09 23:30;15486;2686;522;0;0;18694
2022-11-10 00:30;15443;2621;523;0;0;18587
2022-11-10 01:30;15236;2451;527;0;0;18214
2022-11-10 02:30;14879;2482;527;0;0;17888
2022-11-10 03:30;14874;2483;527;0;0;17884
2022-11-10 04:30;15157;2471;526;0;0;18154
2022-11-10 05:30;16583;2323;526;0;0;19432
2022-11-10 06:30;19755;2401;526;0;0;22682
2022-11-10 07:30;21546;2281;525;0;0;24352
2022-11-10 08:30;20499;2177;522;2;0;23200
2022-11-10 09:30;19846;2063;522;1;0;22432
2022-11-10 10:30;19784;1983;522;1;0;22290
2022-11-10 11:30;19122;1915;519;2;0;21558
2022-11-10 12:30;18953;1825;535;3;0;21316
2022-11-10 13:30;18630;1878;534;1;0;21043
2022-11-10 14:30;18546;1992;533;1;0;21072
2022-11-10 15:30;19598;1941;535;0;0;22074
2022-11-10 16:30;20910;1958;534;0;0;23402
2022-11-10 17:30;22434;1974;535;0;0;24943
2022-11-10 18:30;21009;2013;536;0;0;23558
2022-11-10 19:30;20288;2059;539;0;0;22886
2022-11-10 20:30;19038;2094;537;0;0;21669
2022-11-10 21:30;17675;1790;535;0;0;20000
2022-11-10 22:30;15677;1714;536;0;0;17927
2022-11-10 23:30;14581;1541;529;0;0;16651
2022-11-11 00:30;14986;1507;525;0;0;17018
2022-11-11 01:30;14745;1449;528;0;0;16722
2022-11-11 02:30;14785;1115;529;0;0;16429
2022-11-11 03:30;15174;897;531;0;0;16602
2022-11-11 04:30;15797;899;533;0;0;17229
2022-11-11 05:30;16720;919;531;0;0;18170
2022-11-11 06:30;19693;952;529;0;0;21174
2022-11-11 07:30;21786;871;530;0;0;23187
2022-11-11 08:30;22049;881;535;1;0;23466
2022-11-11 09:30;22451;628;535;1;0;23615
2022-11-11 10:30;22193;765;535;2;0;23495
2022-11-11 11:30;22255;712;533;2;0;23502
2022-11-11 12:30;22647;716;545;2;0;23910
2022-11-11 13:30;22457;759;544;2;0;23762
2022-11-11 14:30;22103;944;542;0;0;23589
2022-11-11 15:30;22258;1039;545;0;0;23842
2022-11-11 16:30;23061;1240;546;0;0;24847
2022-11-11 17:30;23291;1286;543;0;0;25120
2022-11-11 18:30;22918;1360;540;0;0;24818
2022-11-11 19:30;22377;1281;542;0;0;24200
2022-11-11 20:30;21220;1403;545;0;0;23168
2022-11-11 21:30;19967;984;542;0;0;21493
2022-11-11 22:30;18755;943;544;0;0;20242
2022-11-11 23:30;16935;1059;544;0;0;18538
2022-11-12 00:30;15331;1243;543;0;0;17117
2022-11-12 01:30;14526;1309;543;0;0;16378
2022-11-12 02:30;14089;1383;544;0;0;16016
2022-11-12 03:30;13983;1502;543;0;0;16028
2022-11-12 04:30;14414;1572;543;0;0;16529
2022-11-12 05:30;15143;1582;543;0;0;17268
2022-11-12 06:30;15571;1495;541;0;0;17607
2022-11-12 07:30;18103;1181;542;0;0;19826
2022-11-12 08:30;20225;1188;542;0;0;21955
2022-11-12 09:30;21269;1548;542;0;0;23359
2022-11-12 10:30;20402;1814;542;1;0;22759
2022-11-12 11:30;20007;1816;544;0;0;22367
2022-11-12 12:30;20743;1466;555;1;0;22765
2022-11-12 13:30;20241;1289;554;1;0;22085
2022-11-12 14:30;20072;1102;553;2;0;21729
2022-11-12 15:30;20962;885;556;1;0;22404
2022-11-12 16:30;23557;709;561;0;0;24827
2022-11-12 17:30;24239;597;561;0;0;25397
2022-11-12 18:30;23864;569;555;0;0;24988
2022-11-12 19:30;22396;510;557;0;0;23463
2022-11-12 20:30;21757;474;559;0;0;22790
2022-11-12 21:30;21410;480;559;0;0;22449
2022-11-12 22:30;20450;225;560;0;0;21235
2022-11-12 23:30;19385;184;560;0;0;20129
2022-11-13 00:30;18267;220;559;0;0;19046
2022-11-13 01:30;17455;165;557;0;0;18177
2022-11-13 02:30;17308;220;557;0;0;18085
2022-11-13 03:30;17486;201;561;0;0;18248
2022-11-13 04:30;17758;197;562;0;0;18517
2022-11-13 05:30;18426;160;562;0;0;19148
2022-11-13 06:30;19181;141;561;0;0;19883
2022-11-13 07:30;21082;97;561;0;0;21740
2022-11-13 08:30;22262;71;561;0;0;22894
2022-11-13 09:30;23229;45;560;0;0;23834
2022-11-13 10:30;23749;63;562;0;0;24374
2022-11-13 11:30;23963;46;565;1;0;24575
2022-11-13 12:30;24173;70;612;2;0;24857
2022-11-13 13:30;24187;62;613;0;0;24862
2022-11-13 14:30;24111;53;616;0;0;24780
2022-11-13 15:30;24759;149;613;0;0;25521
2022-11-13 16:30;27393;158;614;0;0;28165
2022-11-13 17:30;28294;270;619;0;0;29183
2022-11-13 18:30;28062;393;625;0;0;29080
2022-11-13 19:30;27324;427;627;0;0;28378
2022-11-13 20:30;26717;533;627;0;0;27877
2022-11-13 21:30;25949;565;626;0;0;27140
2022-11-13 22:30;23898;642;628;0;0;25168
2022-11-13 23:30;22176;668;627;0;0;23471
2022-11-14 00:30;22080;859;627;0;0;23566
2022-11-14 01:30;21453;970;627;0;0;23050
2022-11-14 02:30;21256;1042;626;0;0;22924
2022-11-14 03:30;21613;1289;623;0;0;23525
2022-11-14 04:30;21892;1352;626;0;0;23870
2022-11-14 05:30;24247;1321;622;0;0;26190
2022-11-14 06:30;26875;1284;619;0;0;28778
2022-11-14 07:30;28928;1266;621;0;0;30815
2022-11-14 08:30;28502;1301;622;2;0;30427
2022-11-14 09:30;27514;1396;623;2;0;29535
2022-11-14 10:30;27344;1458;623;2;0;29427
2022-11-14 11:30;26846;1419;623;2;0;28890
2022-11-14 12:30;25846;1549;609;4;0;28008
2022-11-14 13:30;26312;1572;608;1;0;28493
2022-11-14 14:30;26244;1667;606;1;0;28518
2022-11-14 15:30;27641;1614;610;0;0;29865
2022-11-14 16:30;29142;1553;614;0;0;31309
2022-11-14 17:30;29709;1636;616;0;0;31961
2022-11-14 18:30;29594;1570;614;0;0;31778
2022-11-14 19:30;29073;1454;618;0;0;31145
2022-11-14 20:30;28322;1350;619;0;0;30291
2022-11-14 21:30;27072;1359;614;0;0;29045
2022-11-14 22:30;26096;1185;610;0;0;27891
2022-11-14 23:30;24597;1053;610;0;0;26260
2022-11-15 00:30;24380;982;609;0;0;25971
2022-11-15 01:30;24030;861;609;0;0;25500
2022-11-15 02:30;23575;790;614;0;0;24979
2022-11-15 03:30;23835;821;612;0;0;25268
2022-11-15 04:30;24633;774;557;0;0;25964
2022-11-15 05:30;26697;653;560;0;0;27910
2022-11-15 06:30;29636;586;557;0;0;30779
2022-11-15 07:30;30350;519;557;0;0;31426
2022-11-15 08:30;28531;413;558;4;0;29506
2022-11-15 09:30;28353;297;559;7;94;29310
2022-11-15 10:30;27991;188;558;8;0;28745
2022-11-15 11:30;27433;164;564;6;0;28167
2022-11-15 12:30;28190;220;586;3;0;28999
2022-11-15 13:30;28444;166;583;1;0;29194
2022-11-15 14:30;28720;143;577;1;0;29441
2022-11-15 15:30;28905;135;581;0;0;29621
2022-11-15 16:30;29072;115;583;0;0;29770
2022-11-15 17:30;30570;143;586;0;0;31299
2022-11-15 18:30;30641;153;587;0;0;31381
2022-11-15 19:30;30599;192;585;0;0;31376
2022-11-15 20:30;29599;235;583;0;0;30417
2022-11-15 21:30;28274;203;584;0;0;29061
2022-11-15 22:30;27111;229;584;0;0;27924
2022-11-15 23:30;26349;235;583;0;0;27167
2022-11-16 00:30;26130;227;584;0;0;26941
2022-11-16 01:30;25336;290;584;0;0;26210
2022-11-16 02:30;25203;328;584;0;0;26115
2022-11-16 03:30;25538;334;583;0;0;26455
2022-11-16 04:30;25889;416;586;0;0;26891
2022-11-16 05:30;26295;476;587;0;0;27358
2022-11-16 06:30;29137;531;589;0;0;30257
2022-11-16 07:30;30619;594;586;0;0;31799
2022-11-16 08:30;30508;553;591;0;0;31652
2022-11-16 09:30;30390;631;593;0;0;31614
2022-11-16 10:30;30560;566;592;0;0;31718
2022-11-16 11:30;30376;565;593;0;0;31534
2022-11-16 12:30;30115;585;571;0;0;31271
2022-11-16 13:30;29957;586;572;0;0;31115
2022-11-16 14:30;29339;620;573;1;0;30533
2022-11-16 15:30;29480;731;572;0;0;30783
2022-11-16 16:30;30517;611;572;0;0;31700
2022-11-16 17:30;31150;542;574;0;0;32266
2022-11-16 18:30;30630;441;577;0;0;31648
2022-11-16 19:30;30207;403;577;0;0;31187
2022-11-16 20:30;29227;488;575;0;0;30290
2022-11-16 21:30;27903;505;626;0;0;29034
2022-11-16 22:30;26737;568;625;0;0;27930
2022-11-16 23:30;26463;570;625;0;0;27658
2022-11-17 00:30;25957;521;622;0;0;27100
2022-11-17 01:30;25811;550;620;0;0;26981
2022-11-17 02:30;25244;495;619;0;0;26358
2022-11-17 03:30;25028;470;622;0;0;26120
2022-11-17 04:30;25308;443;619;0;0;26370
2022-11-17 05:30;27479;407;617;0;0;28503
2022-11-17 06:30;28615;327;619;0;0;29561
2022-11-17 07:30;30430;308;621;0;0;31359
2022-11-17 08:30;30548;263;621;0;0;31432
2022-11-17 09:30;29751;317;623;1;0;30692
2022-11-17 10:30;28946;309;618;1;0;29874
2022-11-17 11:30;28645;310;616;2;0;29573
2022-11-17 12:30;28179;367;614;4;0;29164
2022-11-17 13:30;28231;439;598;1;0;29269
2022-11-17 14:30;28598;594;595;2;0;29789
2022-11-17 15:30;29405;632;593;1;0;30631
2022-11-17 16:30;30642;743;593;0;0;31978
2022-11-17 17:30;31986;989;589;0;0;33564
2022-11-17 18:30;31678;1065;588;0;0;33331
2022-11-17 19:30;30806;1107;588;0;0;32501
2022-11-17 20:30;29891;1191;590;0;0;31672
2022-11-17 21:30;28877;1203;588;0;0;30668
2022-11-17 22:30;27682;1232;591;0;0;29505
2022-11-17 23:30;25914;1212;594;0;0;27720
2022-11-18 00:30;25412;1229;594;0;0;27235
2022-11-18 01:30;24856;1263;593;0;0;26712
2022-11-18 02:30;24924;1245;593;0;0;26762
2022-11-18 03:30;25685;1222;590;0;0;27497
2022-11-18 04:30;26070;1167;588;0;0;27825
2022-11-18 05:30;27534;1112;588;0;0;29234
2022-11-18 06:30;30447;1072;589;0;0;32108
2022-11-18 07:30;31330;1052;589;0;0;32971
2022-11-18 08:30;31131;968;588;0;0;32687
2022-11-18 09:30;30510;844;584;0;0;31938
2022-11-18 10:30;29589;854;587;0;0;31030
2022-11-18 11:30;30097;764;588;0;0;31449
2022-11-18 12:30;29795;751;589;1;0;31136
2022-11-18 13:30;28801;788;602;0;0;30191
2022-11-18 14:30;29401;777;603;0;0;30781
2022-11-18 15:30;29313;681;603;0;0;30597
2022-11-18 16:30;30707;743;605;0;0;32055
2022-11-18 17:30;31699;671;604;0;0;32974
2022-11-18 18:30;31080;680;607;0;0;32367
2022-11-18 19:30;29952;708;609;0;0;31269
2022-11-18 20:30;29793;657;609;0;0;31059
2022-11-18 21:30;28941;714;609;0;0;30264
2022-11-18 22:30;27870;633;609;0;0;29112
2022-11-18 23:30;26890;600;610;0;0;28100
2022-11-19 00:30;26072;646;608;0;0;27326
2022-11-19 01:30;25269;685;606;0;0;26560
2022-11-19 02:30;25277;651;607;0;0;26535
2022-11-19 03:30;25240;628;604;0;0;26472
2022-11-19 04:30;25511;567;603;0;0;26681
2022-11-19 05:30;25800;641;603;0;0;27044
2022-11-19 06:30;27150;667;602;0;0;28419
2022-11-19 07:30;28079;642;599;0;0;29320
2022-11-19 08:30;28448;683;599;0;0;29730
2022-11-19 09:30;28243;528;600;0;0;29371
2022-11-19 10:30;28372;487;600;0;0;29459
2022-11-19 11:30;28427;455;604;2;0;29488
2022-11-19 12:30;27208;437;601;1;0;28247
2022-11-19 13:30;26691;391;631;1;0;27714
2022-11-19 14:30;26421;347;632;1;0;27401
2022-11-19 15:30;26831;471;628;1;0;27931
2022-11-19 16:30;28727;479;631;0;0;29837
2022-11-19 17:30;29795;657;631;0;0;31083
2022-11-19 18:30;28505;681;631;0;0;29817
2022-11-19 19:30;27534;652;631;0;0;28817
2022-11-19 20:30;26602;683;634;0;0;27919
2022-11-19 21:30;25885;669;634;0;0;27188
2022-11-19 22:30;25111;652;635;0;0;26398
2022-11-19 23:30;24488;684;632;0;0;25804
2022-11-20 00:30;23931;623;633;0;0;25187
2022-11-20 01:30;23594;720;634;0;0;24948
2022-11-20 02:30;23426;856;632;0;0;24914
2022-11-20 03:30;23486;896;629;0;0;25011
2022-11-20 04:30;23477;952;632;0;0;25061
2022-11-20 05:30;24733;919;633;0;0;26285
2022-11-20 06:30;25405;1004;632;0;0;27041
2022-11-20 07:30;26297;1074;630;0;0;28001
2022-11-20 08:30;27116;855;631;1;0;28603
2022-11-20 09:30;27334;764;628;1;0;28727
2022-11-20 10:30;26885;807;630;4;0;28326
2022-11-20 11:30;26435;948;632;6;0;28021
2022-11-20 12:30;25848;1086;633;6;0;27573
2022-11-20 13:30;25408;1438;618;7;0;27471
2022-11-20 14:30;25830;1444;618;4;0;27896
2022-11-20 15:30;26826;1674;620;1;0;29121
2022-11-20 16:30;29763;1777;619;0;0;32159
2022-11-20 17:30;30661;1997;612;0;0;33270
2022-11-20 18:30;30058;2191;618;0;0;32867
2022-11-20 19:30;29947;2182;622;0;0;32751
2022-11-20 20:30;29616;2370;621;0;0;32607
2022-11-20 21:30;27858;2439;619;0;0;30916
2022-11-20 22:30;26661;2529;614;0;0;29804
2022-11-20 23:30;26006;2539;615;0;0;29160
2022-11-21 00:30;25059;2642;616;0;0;28317
2022-11-21 01:30;25248;2559;617;0;0;28424
2022-11-21 02:30;25552;2473;613;0;0;28638
2022-11-21 03:30;25602;2431;614;0;0;28647
2022-11-21 04:30;26767;2313;613;0;0;29693
2022-11-21 05:30;28044;2168;613;0;0;30825
2022-11-21 06:30;31044;1976;612;0;0;33632
2022-11-21 07:30;31894;1906;610;0;0;34410
2022-11-21 08:30;31321;1607;612;1;0;33541
2022-11-21 09:30;30112;1561;611;1;0;32285
2022-11-21 10:30;29788;1571;611;1;0;31971
2022-11-21 11:30;29734;1371;612;2;0;31719
2022-11-21 12:30;29470;1278;592;3;0;31343
2022-11-21 13:30;28729;1321;595;6;0;30651
2022-11-21 14:30;28654;1496;595;1;0;30746
2022-11-21 15:30;29117;1474;596;1;0;31188
2022-11-21 16:30;30544;1708;599;0;0;32851
2022-11-21 17:30;31074;1891;605;0;0;33570
2022-11-21 18:30;29922;2181;604;0;0;32707
2022-11-21 19:30;28908;2346;604;0;0;31858
2022-11-21 20:30;27495;2428;604;0;0;30527
2022-11-21 21:30;26489;2464;603;0;0;29556
2022-11-21 22:30;25842;2390;602;0;0;28834
2022-11-21 23:30;24497;2277;600;0;0;27374
2022-11-22 00:30;23892;2215;601;0;0;26708
2022-11-22 01:30;23822;2174;600;0;0;26596
2022-11-22 02:30;23833;2120;600;0;0;26553
2022-11-22 03:30;24157;2274;598;0;0;27029
2022-11-22 04:30;25143;2436;598;0;0;28177
2022-11-22 05:30;27075;2293;599;0;0;29967
2022-11-22 06:30;29597;2189;598;0;0;32384
2022-11-22 07:30;30917;2042;598;0;0;33557
2022-11-22 08:30;29259;2138;593;3;0;31993
2022-11-22 09:30;27430;2141;593;6;0;30170
2022-11-22 10:30;26428;2185;596;8;0;29217
2022-11-22 11:30;25905;2065;593;9;0;28572
2022-11-22 12:30;25732;1843;532;8;0;28115
2022-11-22 13:30;26081;1641;531;7;0;28260
2022-11-22 14:30;26550;1433;531;3;0;28517
2022-11-22 15:30;27844;1474;534;1;0;29853
2022-11-22 16:30;29697;1535;537;0;0;31769
2022-11-22 17:30;30920;1761;541;0;0;33222
2022-11-22 18:30;30642;1760;548;0;0;32950
2022-11-22 19:30;29647;1778;546;0;0;31971
2022-11-22 20:30;28823;1749;544;0;0;31116
2022-11-22 21:30;27567;1677;542;0;0;29786
2022-11-22 22:30;26538;1494;542;0;0;28574
2022-11-22 23:30;26125;1335;540;0;0;28000
2022-11-23 00:30;24287;1172;536;0;0;25995
2022-11-23 01:30;24978;922;538;0;0;26438
2022-11-23 02:30;25181;916;538;0;0;26635
2022-11-23 03:30;25612;956;538;0;0;27106
2022-11-23 04:30;25926;1037;537;0;0;27500
2022-11-23 05:30;27179;1228;539;0;0;28946
2022-11-23 06:30;28872;1319;541;0;0;30732
2022-11-23 07:30;29843;1372;538;0;0;31753
2022-11-23 08:30;29249;1489;538;0;0;31276
2022-11-23 09:30;28181;1625;538;0;0;30344
2022-11-23 10:30;27388;1767;537;1;0;29693
2022-11-23 11:30;26335;1841;536;1;0;28713
2022-11-23 12:30;25967;1815;571;4;0;28357
2022-11-23 13:30;25487;1747;567;2;0;27803
2022-11-23 14:30;25555;1767;571;3;0;27896
2022-11-23 15:30;26108;1682;572;2;0;28364
2022-11-23 16:30;28442;1772;577;0;0;30791
2022-11-23 17:30;29618;1846;576;0;0;32040
2022-11-23 18:30;29502;1724;577;0;0;31803
2022-11-23 19:30;28765;1744;576;0;0;31085
2022-11-23 20:30;28366;1606;579;0;0;30551
2022-11-23 21:30;27654;1544;579;0;0;29777
2022-11-23 22:30;26734;1475;575;0;0;28784
2022-11-23 23:30;26103;1467;574;0;0;28144
2022-11-24 00:30;26185;1362;575;0;0;28122
2022-11-24 01:30;25293;1285;574;0;0;27152
2022-11-24 02:30;25175;1370;570;0;0;27115
2022-11-24 03:30;25336;1307;567;0;0;27210
2022-11-24 04:30;26213;1313;570;0;0;28096
2022-11-24 05:30;28401;1369;569;0;0;30339
2022-11-24 06:30;30159;1485;569;0;0;32213
2022-11-24 07:30;31224;1545;571;0;0;33340
2022-11-24 08:30;30613;1538;569;2;0;32722
2022-11-24 09:30;29763;1466;566;4;0;31799
2022-11-24 10:30;29171;1421;567;8;0;31167
2022-11-24 11:30;29071;1309;565;8;0;30953
2022-11-24 12:30;27854;1218;529;6;0;29607
2022-11-24 13:30;27462;1215;532;4;0;29213
2022-11-24 14:30;27415;1038;534;3;0;28990
2022-11-24 15:30;28577;948;532;1;0;30058
2022-11-24 16:30;29869;1078;534;0;0;31481
2022-11-24 17:30;30982;1097;534;0;0;32613
2022-11-24 18:30;30489;1044;536;0;0;32069
2022-11-24 19:30;29256;1114;535;0;0;30905
2022-11-24 20:30;28989;1036;532;0;0;30557
2022-11-24 21:30;27620;1071;534;0;0;29225
2022-11-24 22:30;26329;1000;534;0;0;27863
2022-11-24 23:30;24793;1057;534;0;0;26384
2022-11-25 00:30;24240;966;533;0;0;25739
2022-11-25 01:30;24012;1004;531;0;0;25547
2022-11-25 02:30;23780;1149;528;0;0;25457
2022-11-25 03:30;23585;1303;530;0;0;25418
2022-11-25 04:30;23786;1345;526;0;0;25657
2022-11-25 05:30;24578;1513;526;0;0;26617
2022-11-25 06:30;26013;1743;526;0;0;28282
2022-11-25 07:30;27177;2083;527;0;0;29787
2022-11-25 08:30;27211;2237;526;0;0;29974
2022-11-25 09:30;27179;1996;526;0;0;29701
2022-11-25 10:30;27095;1924;524;0;0;29543
2022-11-25 11:30;27280;1922;521;0;0;29723
2022-11-25 12:30;26833;1843;521;0;0;29197
2022-11-25 13:30;26457;1845;522;0;0;28824
2022-11-25 14:30;26602;1717;525;0;0;28844
2022-11-25 15:30;27165;1614;528;0;0;29307
2022-11-25 16:30;28046;1627;529;0;0;30202
2022-11-25 17:30;28483;1695;530;0;0;30708
2022-11-25 18:30;27836;1765;532;0;0;30133
2022-11-25 19:30;27157;1611;534;0;0;29302
2022-11-25 20:30;26436;1586;535;0;0;28557
2022-11-25 21:30;25932;1555;532;0;0;28019
2022-11-25 22:30;25166;1489;530;0;0;27185
2022-11-25 23:30;23435;1568;532;0;0;25535
2022-11-26 00:30;22408;1734;528;0;0;24670
2022-11-26 01:30;21409;1860;529;0;0;23798
2022-11-26 02:30;21251;1834;528;0;0;23613
2022-11-26 03:30;21402;1760;529;0;0;23691
2022-11-26 04:30;21877;1624;528;0;0;24029
2022-11-26 05:30;22478;1577;530;0;0;24585
2022-11-26 06:30;23343;1500;532;0;0;25375
2022-11-26 07:30;24571;1408;532;0;0;26511
2022-11-26 08:30;24964;1349;527;1;0;26841
2022-11-26 09:30;24521;1224;528;2;0;26275
2022-11-26 10:30;23920;1190;528;3;0;25641
2022-11-26 11:30;23342;1375;527;8;0;25252
2022-11-26 12:30;22903;1278;534;6;0;24721
2022-11-26 13:30;22295;1209;538;6;0;24048
2022-11-26 14:30;21997;1216;538;4;0;23755
2022-11-26 15:30;22360;1341;537;1;0;24239
2022-11-26 16:30;23772;1491;535;0;0;25798
2022-11-26 17:30;24749;1678;534;0;0;26961
2022-11-26 18:30;23787;1726;538;0;0;26051
2022-11-26 19:30;23173;1751;540;0;0;25464
2022-11-26 20:30;22758;1772;540;0;0;25070
2022-11-26 21:30;22091;1807;540;0;0;24438
2022-11-26 22:30;21639;1638;537;0;0;23814
2022-11-26 23:30;20869;1779;538;0;0;23186
2022-11-27 00:30;20595;1745;536;0;0;22876
2022-11-27 01:30;20661;1629;536;0;0;22826
2022-11-27 02:30;20396;1756;536;0;0;22688
2022-11-27 03:30;20485;1774;532;0;0;22791
2022-11-27 04:30;20685;1831;533;0;0;23049
2022-11-27 05:30;21031;1845;533;0;0;23409
2022-11-27 06:30;21743;1972;534;0;0;24249
2022-11-27 07:30;23083;1920;537;0;0;25540
2022-11-27 08:30;23962;1882;535;0;0;26379
2022-11-27 09:30;24133;1834;537;4;0;26508
2022-11-27 10:30;24042;1663;536;5;0;26246
2022-11-27 11:30;24355;1307;532;2;0;26196
2022-11-27 12:30;24694;1019;555;2;0;26270
2022-11-27 13:30;24260;902;550;6;0;25718
2022-11-27 14:30;24340;758;552;1;0;25651
2022-11-27 15:30;25045;792;553;0;0;26390
2022-11-27 16:30;26468;630;555;0;0;27653
2022-11-27 17:30;27518;451;559;0;0;28528
2022-11-27 18:30;27256;299;555;0;0;28110
2022-11-27 19:30;26410;225;557;0;0;27192
2022-11-27 20:30;26050;142;558;0;0;26750
2022-11-27 21:30;25260;155;559;0;0;25974
2022-11-27 22:30;23654;273;560;0;0;24487
2022-11-27 23:30;22529;293;558;0;0;23380
2022-11-28 00:30;21819;380;556;0;0;22755
2022-11-28 01:30;21496;449;559;0;0;22504
2022-11-28 02:30;21594;491;557;0;0;22642
2022-11-28 03:30;21718;559;555;0;0;22832
2022-11-28 04:30;22114;613;552;0;0;23279
2022-11-28 05:30;23369;728;556;0;0;24653
2022-11-28 06:30;25989;911;560;0;0;27460
2022-11-28 07:30;27815;893;559;0;0;29267
2022-11-28 08:30;27939;956;561;0;0;29456
2022-11-28 09:30;27412;953;561;6;0;28932
2022-11-28 10:30;26904;945;564;6;0;28419
2022-11-28 11:30;26597;914;564;8;0;28083
2022-11-28 12:30;26278;1046;565;1;0;27890
2022-11-28 13:30;26121;1181;570;0;0;27872
2022-11-28 14:30;26147;1345;572;0;0;28064
2022-11-28 15:30;27028;1098;570;0;0;28696
2022-11-28 16:30;28778;1726;574;0;0;31078
2022-11-28 17:30;29896;1903;575;0;0;32374
2022-11-28 18:30;29443;1543;575;0;0;31561
2022-11-28 19:30;28464;1849;573;0;0;30886
2022-11-28 20:30;28026;1746;571;0;0;30343
2022-11-28 21:30;27229;1660;573;0;0;29462
2022-11-28 22:30;26177;1566;571;0;0;28314
2022-11-28 23:30;24979;1442;573;0;0;26994
2022-11-29 00:30;24976;1226;574;0;0;26776
2022-11-29 01:30;24659;1062;575;0;0;26296
2022-11-29 02:30;24794;1041;577;0;0;26412
2022-11-29 03:30;25165;905;576;0;0;26646
2022-11-29 04:30;25913;906;575;0;0;27394
2022-11-29 05:30;27544;848;573;0;0;28965
2022-11-29 06:30;29569;816;572;0;0;30957
2022-11-29 07:30;30651;787;573;0;0;32011
2022-11-29 08:30;30320;949;571;0;0;31840
2022-11-29 09:30;30446;697;570;0;0;31713
2022-11-29 10:30;30652;662;569;0;0;31883
2022-11-29 11:30;30384;595;570;0;0;31549
2022-11-29 12:30;29720;591;595;1;0;30907
2022-11-29 13:30;29742;498;604;1;0;30845
2022-11-29 14:30;29641;435;602;0;0;30678
2022-11-29 15:30;30043;443;607;0;0;31093
2022-11-29 16:30;30974;506;605;0;0;32085
2022-11-29 17:30;31226;502;610;0;0;32338
2022-11-29 18:30;31244;509;612;0;0;32365
2022-11-29 19:30;30939;433;609;0;0;31981
2022-11-29 20:30;29325;459;611;0;0;30395
2022-11-29 21:30;28293;584;610;0;0;29487
2022-11-29 22:30;26419;522;610;0;0;27551
2022-11-29 23:30;25062;571;612;0;0;26245
2022-11-30 00:30;24147;512;610;0;0;25269
2022-11-30 01:30;24083;548;610;0;0;25241
2022-11-30 02:30;23661;666;606;0;0;24933
2022-11-30 03:30;23606;864;606;0;0;25076
2022-11-30 04:30;23385;1264;608;0;0;25257
2022-11-30 05:30;24121;1484;608;0;0;26213
2022-11-30 06:30;26481;1861;610;0;0;28952
2022-11-30 07:30;27751;2134;609;0;0;30494
2022-11-30 08:30;27716;2288;610;0;0;30614
2022-11-30 09:30;27654;2197;608;0;0;30459
2022-11-30 10:30;27373;2220;609;0;0;30202
2022-11-30 11:30;27426;2380;598;0;0;30404
2022-11-30 12:30;26815;2162;562;0;0;29539
2022-11-30 13:30;26691;2004;570;0;0;29265
2022-11-30 14:30;26523;2027;573;0;0;29123
2022-11-30 15:30;26687;2131;571;0;0;29389
2022-11-30 16:30;27281;2654;574;0;0;30509
2022-11-30 17:30;27743;2709;574;0;0;31026
2022-11-30 18:30;27135;2275;577;0;0;29987
2022-11-30 19:30;26353;2333;577;0;0;29263
2022-11-30 20:30;25060;2148;576;0;0;27784
2022-11-30 21:30;24729;2195;572;0;0;27496
2022-11-30 22:30;22880;2170;578;0;0;25628
2022-11-30 23:30;21286;2218;578;0;0;24082
2022-12-01 00:30;20800;2318;578;0;0;23696
2022-12-01 01:30;20889;2177;572;0;0;23638
2022-12-01 02:30;20906;2058;563;0;0;23527
2022-12-01 03:30;20883;2280;560;0;0;23723
2022-12-01 04:30;21466;2505;560;0;0;24531
2022-12-01 05:30;23387;2510;559;0;0;26456
2022-12-01 06:30;25869;2336;559;0;0;28764
2022-12-01 07:30;27923;2319;560;0;0;30802
2022-12-01 08:30;27652;2403;559;0;0;30614
2022-12-01 09:30;26105;2691;562;1;0;29359
2022-12-01 10:30;25696;2787;558;6;0;29047
2022-12-01 11:30;25271;2825;560;8;0;28664
2022-12-01 12:30;25768;2813;561;3;0;29145
2022-12-01 13:30;25200;2945;557;2;0;28704
2022-12-01 14:30;25711;2824;556;1;0;29092
2022-12-01 15:30;26748;2529;556;0;0;29833
2022-12-01 16:30;28375;2562;555;0;0;31492
2022-12-01 17:30;29600;2646;558;0;0;32804
2022-12-01 18:30;29247;2684;560;0;0;32491
2022-12-01 19:30;28226;2711;563;0;0;31500
2022-12-01 20:30;27811;2608;564;0;0;30983
2022-12-01 21:30;26550;2667;563;0;0;29780
2022-12-01 22:30;25727;2604;562;0;0;28893
2022-12-01 23:30;24460;2465;561;0;0;27486
2022-12-02 00:30;24146;2424;562;0;0;27132
2022-12-02 01:30;23702;2303;561;0;0;26566
2022-12-02 02:30;23484;2290;563;0;0;26337
2022-12-02 03:30;23791;2230;561;0;0;26582
2022-12-02 04:30;24251;2018;562;0;0;26831
2022-12-02 05:30;26537;1872;563;0;0;28972
2022-12-02 06:30;29242;1932;562;0;0;31736
2022-12-02 07:30;30805;2150;563;0;0;33518
2022-12-02 08:30;30289;1923;565;1;0;32778
2022-12-02 09:30;28813;1807;558;2;0;31180
2022-12-02 10:30;27554;1508;553;4;0;29619
2022-12-02 11:30;26879;1272;555;5;0;28711
2022-12-02 12:30;26842;1170;557;5;0;28574
2022-12-02 13:30;26530;1126;573;1;0;28230
2022-12-02 14:30;26914;951;571;1;0;28437
2022-12-02 15:30;27251;904;570;1;0;28726
2022-12-02 16:30;28636;1309;569;0;0;30514
2022-12-02 17:30;29156;1551;572;0;0;31279
2022-12-02 18:30;27855;1851;576;0;0;30282
2022-12-02 19:30;26051;2099;580;0;0;28730
2022-12-02 20:30;24869;2251;582;0;0;27702
2022-12-02 21:30;23880;1984;582;0;0;26446
2022-12-02 22:30;22277;2247;584;0;0;25108
2022-12-02 23:30;20839;2376;588;0;0;23803
2022-12-03 00:30;21028;2530;585;0;0;24143
2022-12-03 01:30;20977;2545;586;0;0;24108
2022-12-03 02:30;20483;2524;587;0;0;23594
2022-12-03 03:30;20197;2647;589;0;0;23433
2022-12-03 04:30;20344;2694;587;0;0;23625
2022-12-03 05:30;21117;2754;583;0;0;24454
2022-12-03 06:30;21847;2744;585;0;0;25176
2022-12-03 07:30;22647;2769;586;0;0;26002
2022-12-03 08:30;23575;2691;589;0;0;26855
2022-12-03 09:30;24446;2699;587;0;0;27732
2022-12-03 10:30;25730;2619;588;0;0;28937
2022-12-03 11:30;26155;2465;586;0;0;29206
2022-12-03 12:30;25737;2502;605;0;0;28844
2022-12-03 13:30;24817;2576;609;0;0;28002
2022-12-03 14:30;24455;2528;608;0;0;27591
2022-12-03 15:30;24752;2818;608;0;0;28178
2022-12-03 16:30;25827;2831;608;0;0;29266
2022-12-03 17:30;26622;2890;606;0;0;30118
2022-12-03 18:30;25771;2925;608;0;0;29304
2022-12-03 19:30;24866;2950;609;0;0;28425
2022-12-03 20:30;24526;3002;612;0;0;28140
2022-12-03 21:30;23943;3073;610;0;0;27626
2022-12-03 22:30;23900;2625;610;0;0;27135
2022-12-03 23:30;22384;2601;604;0;0;25589
2022-12-04 00:30;20972;2966;600;0;0;24538
2022-12-04 01:30;21087;2665;599;0;0;24351
2022-12-04 02:30;21242;2366;596;0;0;24204
2022-12-04 03:30;21915;2410;595;0;0;24920
2022-12-04 04:30;22616;2405;595;0;0;25616
2022-12-04 05:30;22946;2226;594;0;0;25766
2022-12-04 06:30;25166;2243;596;0;0;28005
2022-12-04 07:30;26739;2229;596;0;0;29564
2022-12-04 08:30;27654;2123;596;1;0;30374
2022-12-04 09:30;27343;2431;595;5;0;30374
2022-12-04 10:30;26498;1808;593;7;0;28906
2022-12-04 11:30;25665;2168;595;8;0;28436
2022-12-04 12:30;25732;2229;593;2;0;28556
2022-12-04 13:30;25970;1898;613;1;0;28482
2022-12-04 14:30;26125;1763;616;1;0;28505
2022-12-04 15:30;27426;1316;611;0;0;29353
2022-12-04 16:30;30766;1537;609;0;0;32912
2022-12-04 17:30;32014;1546;615;0;0;34175
2022-12-04 18:30;31709;1530;612;0;0;33851
2022-12-04 19:30;30453;1497;611;0;0;32561
2022-12-04 20:30;28811;1597;612;0;0;31020
2022-12-04 21:30;27912;1523;607;0;0;30042
2022-12-04 22:30;26525;1525;609;0;0;28659
2022-12-04 23:30;24805;1465;608;0;0;26878
2022-12-05 00:30;24284;1514;611;0;0;26409
2022-12-05 01:30;23485;1554;611;0;0;25650
2022-12-05 02:30;23360;1674;610;0;0;25644
2022-12-05 03:30;23950;1706;609;0;0;26265
2022-12-05 04:30;24352;1934;609;0;0;26895
2022-12-05 05:30;26006;2109;608;0;0;28723
2022-12-05 06:30;28237;2407;607;0;0;31251
2022-12-05 07:30;29244;2640;608;0;0;32492
2022-12-05 08:30;28788;2844;609;1;0;32242
2022-12-05 09:30;27854;2473;610;5;0;30942
2022-12-05 10:30;26894;2785;608;6;0;30293
2022-12-05 11:30;26011;2722;606;7;0;29346
2022-12-05 12:30;24994;2354;602;7;0;27957
2022-12-05 13:30;25618;2640;619;3;0;28880
2022-12-05 14:30;25917;2299;624;1;0;28841
2022-12-05 15:30;26758;2467;627;1;0;29853
2022-12-05 16:30;28101;2672;630;0;0;31403
2022-12-05 17:30;28763;2655;628;0;0;32046
2022-12-05 18:30;28278;2711;627;0;0;31616
2022-12-05 19:30;27954;2677;627;0;0;31258
2022-12-05 20:30;27104;2531;630;0;0;30265
2022-12-05 21:30;26130;2534;628;0;0;29292
2022-12-05 22:30;25162;2765;622;0;0;28549
2022-12-05 23:30;23136;2308;623;0;0;26067
2022-12-06 00:30;22068;2584;623;0;0;25275
2022-12-06 01:30;21366;2433;621;0;0;24420
2022-12-06 02:30;21376;2431;621;0;0;24428
2022-12-06 03:30;21212;2372;621;0;0;24205
2022-12-06 04:30;23384;2568;621;0;0;26573
2022-12-06 05:30;24551;2534;619;0;0;27704
2022-12-06 06:30;27188;2528;618;0;0;30334
2022-12-06 07:30;28563;2658;613;0;0;31834
2022-12-06 08:30;28071;2749;613;0;0;31433
2022-12-06 09:30;27342;2754;613;1;0;30710
2022-12-06 10:30;26776;2509;614;1;0;29900
2022-12-06 11:30;27060;2409;616;1;0;30086
2022-12-06 12:30;27267;2322;585;0;0;30174
2022-12-06 13:30;27778;2040;588;0;0;30406
2022-12-06 14:30;27915;2079;593;0;0;30587
2022-12-06 15:30;28353;2116;595;0;0;31064
2022-12-06 16:30;29101;2259;591;0;0;31951
2022-12-06 17:30;29663;2155;590;0;0;32408
2022-12-06 18:30;29470;2231;595;0;0;32296
2022-12-06 19:30;28327;2732;592;0;0;31651
2022-12-06 20:30;27588;2721;595;0;0;30904
2022-12-06 21:30;26684;2695;594;0;0;29973
2022-12-06 22:30;24964;2750;590;0;0;28304
2022-12-06 23:30;22828;2718;591;0;0;26137
2022-12-07 00:30;21241;2570;592;0;0;24403
2022-12-07 01:30;20464;2527;591;0;0;23582
2022-12-07 02:30;19492;2448;592;0;0;22532
2022-12-07 03:30;19140;2421;592;0;0;22153
2022-12-07 04:30;19418;2448;590;0;0;22456
2022-12-07 05:30;22374;2505;591;0;0;25470
2022-12-07 06:30;24731;2521;592;0;0;27844
2022-12-07 07:30;26872;2578;591;0;0;30041
2022-12-07 08:30;26881;2557;593;0;0;30031
2022-12-07 09:30;26838;2274;593;0;0;29705
2022-12-07 10:30;26932;2272;594;0;0;29798
2022-12-07 11:30;26841;2240;594;0;0;29675
2022-12-07 12:30;26952;2208;637;1;0;29798
2022-12-07 13:30;26688;1985;640;0;0;29313
2022-12-07 14:30;26822;2113;642;0;0;29577
2022-12-07 15:30;27208;1658;641;0;0;29507
2022-12-07 16:30;28324;1346;640;0;0;30310
2022-12-07 17:30;29334;1274;645;0;0;31253
2022-12-07 18:30;28924;1401;650;0;0;30975
2022-12-07 19:30;28434;1346;649;0;0;30429
2022-12-07 20:30;27161;1293;650;0;0;29104
2022-12-07 21:30;26082;1214;649;0;0;27945
2022-12-07 22:30;24956;1134;650;0;0;26740
2022-12-07 23:30;23179;1097;649;0;0;24925
2022-12-08 00:30;22418;1215;649;0;0;24282
2022-12-08 01:30;20754;1215;650;0;0;22619
2022-12-08 02:30;20321;1267;648;0;0;22236
2022-12-08 03:30;20448;1344;649;0;0;22441
2022-12-08 04:30;21078;1174;649;0;0;22901
2022-12-08 05:30;22385;1025;646;0;0;24056
2022-12-08 06:30;26975;924;645;0;0;28544
2022-12-08 07:30;30010;875;642;0;0;31527
2022-12-08 08:30;29971;787;643;0;0;31401
2022-12-08 09:30;29237;734;643;1;0;30615
2022-12-08 10:30;28044;898;639;3;0;29584
2022-12-08 11:30;26941;987;637;7;0;28572
2022-12-08 12:30;26163;1186;629;7;0;27985
2022-12-08 13:30;26108;1274;628;5;0;28015
2022-12-08 14:30;25973;1348;632;3;0;27956
2022-12-08 15:30;27290;1525;632;1;0;29448
2022-12-08 16:30;29196;1628;630;0;0;31454
2022-12-08 17:30;30294;1636;633;0;0;32563
2022-12-08 18:30;30185;1702;634;0;0;32521
2022-12-08 19:30;30213;1709;634;0;0;32556
2022-12-08 20:30;29695;1663;636;0;0;31994
2022-12-08 21:30;29077;1650;635;0;0;31362
2022-12-08 22:30;27909;1626;634;0;0;30169
2022-12-08 23:30;26590;1504;631;0;0;28725
2022-12-09 00:30;25790;1394;629;0;0;27813
2022-12-09 01:30;25702;1296;630;0;0;27628
2022-12-09 02:30;25353;1307;626;0;0;27286
2022-12-09 03:30;25526;1513;627;0;0;27666
2022-12-09 04:30;26445;1621;630;0;0;28696
2022-12-09 05:30;29426;1617;627;0;0;31670
2022-12-09 06:30;32450;1580;626;0;0;34656
2022-12-09 07:30;33904;1617;627;0;0;36148
2022-12-09 08:30;33422;1589;628;1;0;35640
2022-12-09 09:30;31861;1471;630;5;0;33967
2022-12-09 10:30;31383;1309;629;6;0;33327
2022-12-09 11:30;30742;1324;630;8;0;32704
2022-12-09 12:30;30189;1295;643;8;0;32135
2022-12-09 13:30;29368;1424;644;6;0;31442
2022-12-09 14:30;29359;1629;644;4;0;31636
2022-12-09 15:30;30116;1489;645;1;0;32251
2022-12-09 16:30;32127;1679;641;0;0;34447
2022-12-09 17:30;33150;1696;645;0;0;35491
2022-12-09 18:30;32821;1876;645;0;0;35342
2022-12-09 19:30;32629;1921;643;0;0;35193
2022-12-09 20:30;32287;1895;640;0;0;34822
2022-12-09 21:30;31827;1943;646;0;0;34416
2022-12-09 22:30;30942;1917;644;0;0;33503
2022-12-09 23:30;29489;1906;640;0;0;32035
2022-12-10 00:30;29036;1861;638;0;0;31535
2022-12-10 01:30;29677;1754;637;0;0;32068
2022-12-10 02:30;29689;1882;636;0;0;32207
2022-12-10 03:30;30487;2010;638;0;0;33135
2022-12-10 04:30;31027;1997;638;0;0;33662
2022-12-10 05:30;31994;2412;638;0;0;35044
2022-12-10 06:30;32910;2345;638;0;0;35893
2022-12-10 07:30;34143;2255;638;0;0;37036
2022-12-10 08:30;34307;2075;636;1;0;37019
2022-12-10 09:30;33253;1840;633;5;0;35731
2022-12-10 10:30;33000;1545;634;6;0;35185
2022-12-10 11:30;32324;1239;634;8;0;34205
2022-12-10 12:30;32507;1084;632;8;0;34231
2022-12-10 13:30;31926;1038;634;6;0;33604
2022-12-10 14:30;31484;1196;636;4;0;33320
2022-12-10 15:30;32522;1255;634;1;0;34412
2022-12-10 16:30;34464;1488;629;0;0;36581
2022-12-10 17:30;34388;1577;637;0;0;36602
2022-12-10 18:30;34203;1592;639;0;0;36434
2022-12-10 19:30;34338;1653;640;0;0;36631
2022-12-10 20:30;33385;1743;638;0;0;35766
2022-12-10 21:30;32680;1803;635;0;0;35118
2022-12-10 22:30;32523;1783;631;0;0;34937
2022-12-10 23:30;31472;1665;632;0;0;33769
2022-12-11 00:30;31606;1568;637;0;0;33811
2022-12-11 01:30;31651;1466;634;0;0;33751
2022-12-11 02:30;31522;1414;634;0;0;33570
2022-12-11 03:30;31723;1293;635;0;0;33651
2022-12-11 04:30;32050;1147;633;0;0;33830
2022-12-11 05:30;32708;1066;633;0;0;34407
2022-12-11 06:30;33663;989;633;0;0;35285
2022-12-11 07:30;33948;907;637;0;0;35492
2022-12-11 08:30;34788;836;632;0;0;36256
2022-12-11 09:30;34853;559;634;1;0;36047
2022-12-11 10:30;34827;362;630;1;0;35820
2022-12-11 11:30;35058;242;625;1;0;35926
2022-12-11 12:30;35079;221;626;1;0;35927
2022-12-11 13:30;35065;249;628;1;0;35943
2022-12-11 14:30;34866;299;630;1;0;35796
2022-12-11 15:30;34578;374;628;0;0;35580
2022-12-11 16:30;34446;543;635;0;0;35624
2022-12-11 17:30;34404;645;639;0;0;35688
2022-12-11 18:30;34365;786;639;0;0;35790
2022-12-11 19:30;34974;832;638;0;0;36444
2022-12-11 20:30;34260;848;636;0;0;35744
2022-12-11 21:30;33966;854;633;0;0;35453
2022-12-11 22:30;33265;780;619;0;0;34664
2022-12-11 23:30;32357;773;620;0;0;33750
2022-12-12 00:30;31643;763;621;0;0;33027
2022-12-12 01:30;31414;761;625;0;0;32800
2022-12-12 02:30;31396;774;625;0;0;32795
2022-12-12 03:30;31983;816;628;0;0;33427
2022-12-12 04:30;32406;795;632;0;0;33833
2022-12-12 05:30;33915;782;631;0;0;35328
2022-12-12 06:30;34838;938;627;0;0;36403
2022-12-12 07:30;35188;1101;627;0;0;36916
2022-12-12 08:30;34694;1019;627;1;0;36341
2022-12-12 09:30;34166;852;628;5;0;35651
2022-12-12 10:30;33563;830;624;2;0;35019
2022-12-12 11:30;33616;890;623;1;0;35130
2022-12-12 12:30;32678;825;624;1;0;34128
2022-12-12 13:30;32399;849;632;1;0;33881
2022-12-12 14:30;31732;976;631;1;0;33340
2022-12-12 15:30;32705;1322;629;0;0;34656
2022-12-12 16:30;34210;1783;633;0;0;36626
2022-12-12 17:30;34725;1853;635;0;0;37213
2022-12-12 18:30;34983;1681;637;0;0;37301
2022-12-12 19:30;34861;1429;639;0;0;36929
2022-12-12 20:30;34733;1333;639;0;0;36705
2022-12-12 21:30;33764;1282;637;0;0;35683
2022-12-12 22:30;32747;1150;635;0;0;34532
2022-12-12 23:30;31632;1019;636;0;0;33287
2022-12-13 00:30;32113;1045;635;0;0;33793
2022-12-13 01:30;31973;1052;635;0;0;33660
2022-12-13 02:30;32183;1029;634;0;0;33846
2022-12-13 03:30;32363;1041;635;0;0;34039
2022-12-13 04:30;32907;1050;626;0;0;34583
2022-12-13 05:30;32989;985;619;0;0;34593
2022-12-13 06:30;34858;806;614;0;0;36278
2022-12-13 07:30;35404;854;610;0;0;36868
2022-12-13 08:30;34876;734;611;1;0;36222
2022-12-13 09:30;35319;639;606;4;0;36568
2022-12-13 10:30;34303;568;604;4;0;35479
2022-12-13 11:30;33490;705;605;3;0;34803
2022-12-13 12:30;31917;744;618;6;0;33285
2022-12-13 13:30;31632;903;621;5;0;33161
2022-12-13 14:30;31493;1124;618;4;0;33239
2022-12-13 15:30;32091;1418;617;1;0;34127
2022-12-13 16:30;33792;1592;616;0;0;36000
2022-12-13 17:30;34649;1714;622;0;0;36985
2022-12-13 18:30;34201;1827;625;0;0;36653
2022-12-13 19:30;33953;1754;629;0;0;36336
2022-12-13 20:30;33525;1446;629;0;0;35600
2022-12-13 21:30;32440;1535;632;0;0;34607
2022-12-13 22:30;31976;1521;635;0;0;34132
2022-12-13 23:30;30381;1785;636;0;0;32802
2022-12-14 00:30;29883;1963;637;0;0;32483
2022-12-14 01:30;29815;2161;640;0;0;32616
2022-12-14 02:30;29794;2181;644;0;0;32619
2022-12-14 03:30;29990;2089;643;0;0;32722
2022-12-14 04:30;30848;1977;646;0;0;33471
2022-12-14 05:30;31905;1943;646;0;0;34494
2022-12-14 06:30;33640;1841;637;0;0;36118
2022-12-14 07:30;35002;1839;636;0;0;37477
2022-12-14 08:30;34692;1834;636;0;0;37162
2022-12-14 09:30;33743;1803;634;1;0;36181
2022-12-14 10:30;32552;1863;635;2;0;35052
2022-12-14 11:30;31499;2189;633;6;0;34327
2022-12-14 12:30;30488;2216;635;4;0;33343
2022-12-14 13:30;30137;2262;604;3;0;33006
2022-12-14 14:30;29946;2264;603;2;0;32815
2022-12-14 15:30;30776;2239;606;0;0;33621
2022-12-14 16:30;32180;2240;607;0;0;35027
2022-12-14 17:30;32782;2155;610;0;0;35547
2022-12-14 18:30;32319;2075;612;0;0;35006
2022-12-14 19:30;32011;1909;611;0;0;34531
2022-12-14 20:30;31241;1914;612;0;0;33767
2022-12-14 21:30;30222;1945;608;0;0;32775
2022-12-14 22:30;28574;1934;609;0;0;31117
2022-12-14 23:30;27330;1889;607;0;0;29826
2022-12-15 00:30;26482;1807;615;0;0;28904
2022-12-15 01:30;26208;1663;614;0;0;28485
2022-12-15 02:30;26094;1516;617;0;0;28227
2022-12-15 03:30;25836;1516;611;0;0;27963
2022-12-15 04:30;26516;1418;609;0;0;28543
2022-12-15 05:30;27920;1332;610;0;0;29862
2022-12-15 06:30;30182;1448;606;0;0;32236
2022-12-15 07:30;31932;1280;603;0;0;33815
2022-12-15 08:30;31208;1255;605;1;0;33069
2022-12-15 09:30;30098;1153;605;5;0;31861
2022-12-15 10:30;29886;926;608;5;0;31425
2022-12-15 11:30;29657;962;611;4;0;31234
2022-12-15 12:30;29437;945;618;2;0;31002
2022-12-15 13:30;29102;901;615;4;0;30622
2022-12-15 14:30;29364;951;616;1;0;30932
2022-12-15 15:30;30160;870;620;0;0;31650
2022-12-15 16:30;31596;809;625;0;0;33030
2022-12-15 17:30;31768;936;621;0;0;33325
2022-12-15 18:30;31679;916;624;0;0;33219
2022-12-15 19:30;31106;889;623;0;0;32618
2022-12-15 20:30;30595;850;623;0;0;32068
2022-12-15 21:30;29931;944;621;0;0;31496
2022-12-15 22:30;28660;995;621;0;0;30276
2022-12-15 23:30;27389;930;619;0;0;28938
2022-12-16 00:30;27202;957;615;0;0;28774
2022-12-16 01:30;26938;995;615;0;0;28548
2022-12-16 02:30;26579;993;617;0;0;28189
2022-12-16 03:30;26898;888;616;0;0;28402
2022-12-16 04:30;27538;781;615;0;0;28934
2022-12-16 05:30;29020;663;618;0;0;30301
2022-12-16 06:30;30813;665;617;0;0;32095
2022-12-16 07:30;32078;654;617;0;0;33349
2022-12-16 08:30;32533;608;621;0;0;33762
2022-12-16 09:30;33120;595;618;0;0;34333
2022-12-16 10:30;32718;533;615;0;0;33866
2022-12-16 11:30;32784;566;617;0;0;33967
2022-12-16 12:30;32314;611;598;0;0;33523
2022-12-16 13:30;31998;674;599;1;0;33272
2022-12-16 14:30;31821;801;598;0;0;33220
2022-12-16 15:30;32001;876;597;0;0;33474
2022-12-16 16:30;33162;874;600;0;0;34636
2022-12-16 17:30;33352;814;604;0;0;34770
2022-12-16 18:30;32860;801;604;0;0;34265
2022-12-16 19:30;32299;822;602;0;0;33723
2022-12-16 20:30;31354;897;603;0;0;32854
2022-12-16 21:30;30556;881;604;0;0;32041
2022-12-16 22:30;29917;904;605;0;0;31426
2022-12-16 23:30;28986;876;605;0;0;30467
2022-12-17 00:30;28404;848;607;0;0;29859
2022-12-17 01:30;28224;824;607;0;0;29655
2022-12-17 02:30;28350;799;604;0;0;29753
2022-12-17 03:30;28288;798;604;0;0;29690
2022-12-17 04:30;28465;796;606;0;0;29867
2022-12-17 05:30;28816;792;605;0;0;30213
2022-12-17 06:30;29877;753;605;0;0;31235
2022-12-17 07:30;30954;713;598;0;0;32265
2022-12-17 08:30;31546;662;601;0;0;32809
2022-12-17 09:30;31559;610;597;0;0;32766
2022-12-17 10:30;31349;601;592;0;0;32542
2022-12-17 11:30;31552;615;591;1;0;32759
2022-12-17 12:30;31167;635;621;1;0;32424
2022-12-17 13:30;30964;626;622;1;0;32213
2022-12-17 14:30;30730;592;621;0;0;31943
2022-12-17 15:30;31317;555;626;0;0;32498
2022-12-17 16:30;32162;586;624;0;0;33372
2022-12-17 17:30;32741;567;627;0;0;33935
2022-12-17 18:30;32130;551;631;0;0;33312
2022-12-17 19:30;31698;541;633;0;0;32872
2022-12-17 20:30;31106;494;632;0;0;32232
2022-12-17 21:30;30516;493;634;0;0;31643
2022-12-17 22:30;30030;431;629;0;0;31090
2022-12-17 23:30;28834;398;622;0;0;29854
2022-12-18 00:30;28394;359;624;0;0;29377
2022-12-18 01:30;28105;324;622;0;0;29051
2022-12-18 02:30;27908;271;622;0;0;28801
2022-12-18 03:30;27795;250;623;0;0;28668
2022-12-18 04:30;28161;227;623;0;0;29011
2022-12-18 05:30;28812;180;622;0;0;29614
2022-12-18 06:30;29665;187;625;0;0;30477
2022-12-18 07:30;31026;194;625;0;0;31845
2022-12-18 08:30;31651;183;625;0;0;32459
2022-12-18 09:30;31969;169;624;1;0;32763
2022-12-18 10:30;31731;126;619;3;0;32479
2022-12-18 11:30;31303;95;622;1;0;32021
2022-12-18 12:30;30329;121;610;1;0;31061
2022-12-18 13:30;30204;116;612;3;0;30935
2022-12-18 14:30;30439;95;612;2;0;31148
2022-12-18 15:30;31453;88;611;0;0;32152
2022-12-18 16:30;32796;89;608;0;0;33493
2022-12-18 17:30;33737;117;614;0;0;34468
2022-12-18 18:30;33781;148;614;0;0;34543
2022-12-18 19:30;33202;170;617;0;0;33989
2022-12-18 20:30;32536;163;622;0;0;33321
2022-12-18 21:30;31592;180;627;0;0;32399
2022-12-18 22:30;30315;180;624;0;0;31119
2022-12-18 23:30;29452;187;622;0;0;30261
2022-12-19 00:30;28497;215;620;0;0;29332
2022-12-19 01:30;28297;254;621;0;0;29172
2022-12-19 02:30;28003;276;618;0;0;28897
2022-12-19 03:30;28220;331;619;0;0;29170
2022-12-19 04:30;28663;377;616;0;0;29656
2022-12-19 05:30;28928;391;617;0;0;29936
2022-12-19 06:30;28551;378;621;0;0;29550
2022-12-19 07:30;29427;400;620;0;0;30447
2022-12-19 08:30;29176;461;620;0;185;30442
2022-12-19 09:30;29099;473;621;1;0;30194
2022-12-19 10:30;29137;485;618;2;0;30242
2022-12-19 11:30;28746;474;616;1;0;29837
2022-12-19 12:30;28126;532;624;3;0;29285
2022-12-19 13:30;27305;651;623;5;0;28584
2022-12-19 14:30;27408;864;624;3;0;28899
2022-12-19 15:30;28401;937;624;0;0;29962
2022-12-19 16:30;29605;995;624;0;0;31224
2022-12-19 17:30;30205;1013;623;0;0;31841
2022-12-19 18:30;30099;970;626;0;0;31695
2022-12-19 19:30;29911;886;625;0;0;31422
2022-12-19 20:30;29376;881;625;0;0;30882
2022-12-19 21:30;28851;789;625;0;0;30265
2022-12-19 22:30;28018;747;630;0;0;29395
2022-12-19 23:30;26877;768;629;0;0;28274
2022-12-20 00:30;27894;682;626;0;0;29202
2022-12-20 01:30;28519;718;625;0;0;29862
2022-12-20 02:30;28127;664;627;0;0;29418
2022-12-20 03:30;27995;706;627;0;0;29328
2022-12-20 04:30;27546;704;624;0;0;28874
2022-12-20 05:30;28340;724;624;0;0;29688
2022-12-20 06:30;29032;677;622;0;0;30331
2022-12-20 07:30;29693;638;622;0;0;30953
2022-12-20 08:30;29665;580;622;0;0;30867
2022-12-20 09:30;29639;430;620;1;0;30690
2022-12-20 10:30;30307;341;620;2;0;31270
2022-12-20 11:30;30099;253;619;3;0;30974
2022-12-20 12:30;29551;183;564;2;0;30300
2022-12-20 13:30;29739;135;563;2;0;30439
2022-12-20 14:30;29374;131;567;1;0;30073
2022-12-20 15:30;28728;126;566;1;0;29421
2022-12-20 16:30;29240;118;568;0;0;29926
2022-12-20 17:30;30265;144;565;0;0;30974
2022-12-20 18:30;30025;117;567;0;0;30709
2022-12-20 19:30;30237;69;568;0;0;30874
2022-12-20 20:30;28950;36;565;0;0;29551
2022-12-20 21:30;28707;33;564;0;0;29304
2022-12-20 22:30;27816;14;562;0;0;28392
2022-12-20 23:30;27802;31;562;0;0;28395
2022-12-21 00:30;28274;4;563;0;0;28841
2022-12-21 01:30;28012;5;563;0;0;28580
2022-12-21 02:30;27625;29;564;0;0;28218
2022-12-21 03:30;27367;26;565;0;0;27958
2022-12-21 04:30;27172;31;566;0;0;27769
2022-12-21 05:30;27391;31;565;0;0;27987
2022-12-21 06:30;28819;82;564;0;0;29465
2022-12-21 07:30;29842;91;563;0;0;30496
2022-12-21 08:30;29527;104;563;0;0;30194
2022-12-21 09:30;29174;99;557;1;0;29831
2022-12-21 10:30;29342;163;556;2;0;30063
2022-12-21 11:30;29144;216;553;3;0;29916
2022-12-21 12:30;29276;291;551;3;0;30121
2022-12-21 13:30;29925;344;553;1;0;30823
2022-12-21 14:30;29754;463;554;1;0;30772
2022-12-21 15:30;28778;509;554;1;0;29842
2022-12-21 16:30;28605;495;556;0;0;29656
2022-12-21 17:30;29343;552;553;0;0;30448
2022-12-21 18:30;29910;588;554;0;0;31052
2022-12-21 19:30;30046;611;554;0;0;31211
2022-12-21 20:30;29210;540;556;0;0;30306
2022-12-21 21:30;28134;552;557;0;0;29243
2022-12-21 22:30;28417;612;557;0;0;29586
2022-12-21 23:30;25872;604;557;0;0;27033
2022-12-22 00:30;26055;620;551;0;0;27226
2022-12-22 01:30;26053;669;550;0;0;27272
2022-12-22 02:30;25608;671;553;0;0;26832
2022-12-22 03:30;26997;623;554;0;0;28174
2022-12-22 04:30;28018;597;553;0;0;29168
2022-12-22 05:30;27141;560;552;0;0;28253
2022-12-22 06:30;27970;658;551;0;0;29179
2022-12-22 07:30;29080;675;551;0;0;30306
2022-12-22 08:30;28970;684;552;1;0;30207
2022-12-22 09:30;29310;524;546;1;0;30381
2022-12-22 10:30;29578;422;546;2;0;30548
2022-12-22 11:30;29108;350;545;4;0;30007
2022-12-22 12:30;28417;314;552;5;0;29288
2022-12-22 13:30;28948;328;552;3;0;29831
2022-12-22 14:30;28827;306;556;3;0;29692
2022-12-22 15:30;29560;387;554;1;0;30502
2022-12-22 16:30;29431;547;555;0;0;30533
2022-12-22 17:30;30119;622;559;0;0;31300
2022-12-22 18:30;29534;720;558;0;0;30812
2022-12-22 19:30;29615;802;560;0;0;30977
2022-12-22 20:30;29037;812;560;0;0;30409
2022-12-22 21:30;28730;843;556;0;0;30129
2022-12-22 22:30;28268;995;556;0;0;29819
2022-12-22 23:30;27058;1160;553;0;0;28771
2022-12-23 00:30;26712;1352;554;0;0;28618
2022-12-23 01:30;25931;1691;554;0;0;28176
2022-12-23 02:30;25488;1616;554;0;0;27658
2022-12-23 03:30;25222;1712;555;0;0;27489
2022-12-23 04:30;25224;1766;554;0;0;27544
2022-12-23 05:30;25904;1758;551;0;0;28213
2022-12-23 06:30;26489;1820;551;0;0;28860
2022-12-23 07:30;27287;1818;553;0;0;29658
2022-12-23 08:30;27576;1877;553;0;0;30006
2022-12-23 09:30;27071;1932;553;1;0;29557
2022-12-23 10:30;27099;1819;558;3;0;29479
2022-12-23 11:30;27268;1879;552;0;0;29699
2022-12-23 12:30;27727;1608;572;0;0;29907
2022-12-23 13:30;27205;1623;571;0;0;29399
2022-12-23 14:30;26642;1995;571;1;0;29209
2022-12-23 15:30;26555;1982;575;0;0;29112
2022-12-23 16:30;28192;1784;571;0;0;30547
2022-12-23 17:30;28004;1645;571;0;0;30220
2022-12-23 18:30;28570;1553;575;0;0;30698
2022-12-23 19:30;28315;1647;576;0;0;30538
2022-12-23 20:30;27939;1512;575;0;0;30026
2022-12-23 21:30;28027;1336;573;0;0;29936
2022-12-23 22:30;27320;1274;573;0;0;29167
2022-12-23 23:30;26630;1375;574;0;0;28579
2022-12-24 00:30;27154;1483;574;0;0;29211
2022-12-24 01:30;26343;1492;572;0;0;28407
2022-12-24 02:30;26119;1660;571;0;0;28350
2022-12-24 03:30;27119;1784;572;0;0;29475
2022-12-24 04:30;27176;1867;573;0;0;29616
2022-12-24 05:30;26736;1463;571;0;0;28770
2022-12-24 06:30;27753;1739;574;0;0;30066
2022-12-24 07:30;27497;1766;574;0;0;29837
2022-12-24 08:30;28347;1740;576;0;0;30663
2022-12-24 09:30;29020;1902;577;1;0;31500
2022-12-24 10:30;29023;2117;580;2;0;31722
2022-12-24 11:30;29739;1967;583;1;0;32290
2022-12-24 12:30;29994;1804;582;2;0;32382
2022-12-24 13:30;30173;1881;578;1;0;32633
2022-12-24 14:30;30840;1700;577;1;0;33118
2022-12-24 15:30;30371;1591;578;0;0;32540
2022-12-24 16:30;29751;1606;578;0;0;31935
2022-12-24 17:30;29861;1593;572;0;0;32026
2022-12-24 18:30;29562;1723;576;0;0;31861
2022-12-24 19:30;29412;1768;576;0;0;31756
2022-12-24 20:30;29034;1766;574;0;0;31374
2022-12-24 21:30;28541;1857;572;0;0;30970
2022-12-24 22:30;28784;1781;572;0;0;31137
2022-12-24 23:30;28306;1796;572;0;0;30674
2022-12-25 00:30;27666;1714;570;0;0;29950
2022-12-25 01:30;27136;1751;566;0;0;29453
2022-12-25 02:30;27436;1864;570;0;0;29870
2022-12-25 03:30;27376;1877;572;0;0;29825
2022-12-25 04:30;27636;1786;570;0;0;29992
2022-12-25 05:30;27712;1872;569;0;0;30153
2022-12-25 06:30;28374;1871;569;0;0;30814
2022-12-25 07:30;29122;1844;570;0;0;31536
2022-12-25 08:30;29601;1937;570;0;0;32108
2022-12-25 09:30;29736;1985;572;1;0;32294
2022-12-25 10:30;29561;1969;570;1;0;32101
2022-12-25 11:30;29356;2069;569;1;0;31995
2022-12-25 12:30;29122;1995;538;3;0;31658
2022-12-25 13:30;28916;1958;539;1;0;31414
2022-12-25 14:30;28773;1989;540;1;0;31303
2022-12-25 15:30;28603;1950;541;0;0;31094
2022-12-25 16:30;29105;1896;541;0;0;31542
2022-12-25 17:30;28929;2072;543;0;0;31544
2022-12-25 18:30;28128;2247;543;0;0;30918
2022-12-25 19:30;27608;2263;543;0;0;30414
2022-12-25 20:30;27361;1989;543;0;0;29893
2022-12-25 21:30;27221;1820;542;0;0;29583
2022-12-25 22:30;26863;1892;542;0;0;29297
2022-12-25 23:30;26822;1797;537;0;0;29156
2022-12-26 00:30;25740;1806;535;0;0;28081
2022-12-26 01:30;25409;1591;536;0;0;27536
2022-12-26 02:30;25678;1493;534;0;0;27705
2022-12-26 03:30;25828;1488;531;0;0;27847
2022-12-26 04:30;26304;1438;531;0;0;28273
2022-12-26 05:30;26590;1729;531;0;0;28850
2022-12-26 06:30;27447;1612;530;0;0;29589
2022-12-26 07:30;28061;1728;531;0;0;30320
2022-12-26 08:30;28135;1842;531;0;0;30508
2022-12-26 09:30;28519;1818;531;0;0;30868
2022-12-26 10:30;28478;2016;531;1;0;31026
2022-12-26 11:30;28567;1967;532;2;0;31068
2022-12-26 12:30;29132;1840;534;0;0;31506
2022-12-26 13:30;28979;1876;540;1;0;31396
2022-12-26 14:30;28486;1742;542;0;0;30770
2022-12-26 15:30;28380;1710;542;0;0;30632
2022-12-26 16:30;29057;1694;543;0;0;31294
2022-12-26 17:30;28699;1661;543;0;0;30903
2022-12-26 18:30;28244;1669;541;0;0;30454
2022-12-26 19:30;27847;1588;544;0;0;29979
2022-12-26 20:30;27170;1506;545;0;0;29221
2022-12-26 21:30;26870;1522;546;0;0;28938
2022-12-26 22:30;26452;1521;547;0;0;28520
2022-12-26 23:30;25629;1420;547;0;0;27596
2022-12-27 00:30;25635;1294;542;0;0;27471
2022-12-27 01:30;25551;1108;539;0;0;27198
2022-12-27 02:30;25640;986;538;0;0;27164
2022-12-27 03:30;25873;897;540;0;0;27310
2022-12-27 04:30;25910;860;539;0;0;27309
2022-12-27 05:30;26520;815;538;0;0;27873
2022-12-27 06:30;27403;822;538;0;0;28763
2022-12-27 07:30;28294;759;536;0;0;29589
2022-12-27 08:30;28844;752;538;0;0;30134
2022-12-27 09:30;30609;600;539;0;0;31748
2022-12-27 10:30;30437;611;542;0;0;31590
2022-12-27 11:30;30155;833;546;1;0;31535
2022-12-27 12:30;30061;1077;599;2;0;31739
2022-12-27 13:30;30063;1144;599;1;0;31807
2022-12-27 14:30;29897;1166;604;0;0;31667
2022-12-27 15:30;29847;1109;602;0;0;31558
2022-12-27 16:30;30691;1393;605;0;0;32689
2022-12-27 17:30;31471;1754;603;0;0;33828
2022-12-27 18:30;29624;1932;605;0;0;32161
2022-12-27 19:30;29882;2024;608;0;0;32514
2022-12-27 20:30;28927;1988;605;0;0;31520
2022-12-27 21:30;28454;2020;605;0;0;31079
2022-12-27 22:30;27944;2051;604;0;0;30599
2022-12-27 23:30;27727;1862;603;0;0;30192
2022-12-28 00:30;27481;1702;603;0;0;29786
2022-12-28 01:30;26933;1524;603;0;0;29060
2022-12-28 02:30;27268;1343;602;0;0;29213
2022-12-28 03:30;27166;1156;600;0;0;28922
2022-12-28 04:30;27403;1097;596;0;0;29096
2022-12-28 05:30;28323;1084;594;0;0;30001
2022-12-28 06:30;29343;1158;593;0;0;31094
2022-12-28 07:30;29360;1159;594;0;0;31113
2022-12-28 08:30;29734;1171;597;0;0;31502
2022-12-28 09:30;30158;1077;594;0;0;31829
2022-12-28 10:30;29210;911;594;0;0;30715
2022-12-28 11:30;29686;745;594;0;0;31025
2022-12-28 12:30;29938;693;595;0;0;31226
2022-12-28 13:30;30177;621;598;0;0;31396
2022-12-28 14:30;29423;555;593;0;0;30571
2022-12-28 15:30;29719;458;592;0;0;30769
2022-12-28 16:30;30595;418;593;0;0;31606
2022-12-28 17:30;30690;432;593;0;0;31715
2022-12-28 18:30;30221;407;598;0;0;31226
2022-12-28 19:30;29514;392;595;0;0;30501
2022-12-28 20:30;28658;331;596;0;0;29585
2022-12-28 21:30;27978;336;597;0;0;28911
2022-12-28 22:30;27154;295;596;0;0;28045
2022-12-28 23:30;26285;318;595;0;0;27198
2022-12-29 00:30;25308;359;594;0;0;26261
2022-12-29 01:30;24868;398;596;0;0;25862
2022-12-29 02:30;24786;378;591;0;0;25755
2022-12-29 03:30;24843;338;590;0;0;25771
2022-12-29 04:30;25065;357;589;0;0;26011
2022-12-29 05:30;25604;384;593;0;0;26581
2022-12-29 06:30;26985;449;590;0;0;28024
2022-12-29 07:30;27841;518;589;0;0;28948
2022-12-29 08:30;28130;611;582;0;0;29323
2022-12-29 09:30;28426;619;590;0;0;29635
2022-12-29 10:30;27652;809;588;2;0;29051
2022-12-29 11:30;27563;933;586;2;0;29084
2022-12-29 12:30;26248;949;587;6;0;27790
2022-12-29 13:30;25106;980;599;5;0;26690
2022-12-29 14:30;25393;994;599;3;0;26989
2022-12-29 15:30;26329;1040;605;0;0;27974
2022-12-29 16:30;27325;1292;606;0;0;29223
2022-12-29 17:30;27612;1455;608;0;0;29675
2022-12-29 18:30;26697;1635;610;0;0;28942
2022-12-29 19:30;25853;1775;611;0;0;28239
2022-12-29 20:30;24818;1861;610;0;0;27289
2022-12-29 21:30;24062;1896;610;0;0;26568
2022-12-29 22:30;23105;1922;609;0;0;25636
2022-12-29 23:30;21712;1712;607;0;0;24031
2022-12-30 00:30;21602;1619;607;0;0;23828
2022-12-30 01:30;21400;1583;607;0;0;23590
2022-12-30 02:30;20957;1486;605;0;0;23048
2022-12-30 03:30;21039;1557;604;0;0;23200
2022-12-30 04:30;21175;1575;607;0;0;23357
2022-12-30 05:30;22210;1495;606;0;0;24311
2022-12-30 06:30;23053;1440;606;0;0;25099
2022-12-30 07:30;23944;1415;604;0;0;25963
2022-12-30 08:30;24971;1391;605;0;0;26967
2022-12-30 09:30;25339;1357;606;0;0;27302
2022-12-30 10:30;25422;1510;605;1;0;27538
2022-12-30 11:30;25374;1532;602;1;0;27509
2022-12-30 12:30;25355;1548;603;0;0;27506
2022-12-30 13:30;24959;1559;567;0;0;27085
2022-12-30 14:30;24222;1739;567;0;0;26528
2022-12-30 15:30;24086;2114;568;0;0;26768
2022-12-30 16:30;25374;1950;569;0;0;27893
2022-12-30 17:30;25664;2139;567;0;0;28370
2022-12-30 18:30;24519;2415;570;0;0;27504
2022-12-30 19:30;23521;2843;570;0;0;26934
2022-12-30 20:30;22623;2518;569;0;0;25710
2022-12-30 21:30;21743;2473;569;0;0;24785
2022-12-30 22:30;21067;2378;566;0;0;24011
2022-12-30 23:30;20377;2183;561;0;0;23121
2022-12-31 00:30;18773;2202;561;0;0;21536
2022-12-31 01:30;18379;2136;544;0;0;21059
2022-12-31 02:30;18024;2575;485;0;0;21084
2022-12-31 03:30;17912;2261;484;0;0;20657
2022-12-31 04:30;18276;2438;483;0;0;21197
2022-12-31 05:30;18508;2467;483;0;0;21458
2022-12-31 06:30;19019;2293;485;0;0;21797
2022-12-31 07:30;20179;2017;485;0;0;22681
2022-12-31 08:30;21245;1746;486;0;0;23477
2022-12-31 09:30;23101;1396;486;0;0;24983
2022-12-31 10:30;24481;1075;486;0;0;26042
2022-12-31 11:30;24700;828;486;0;0;26014
2022-12-31 12:30;24819;766;490;1;0;26076
2022-12-31 13:30;24418;702;490;1;0;25611
2022-12-31 14:30;24318;581;491;0;0;25390
2022-12-31 15:30;24668;484;490;0;0;25642
2022-12-31 16:30;26235;395;491;0;0;27121
2022-12-31 17:30;26573;348;491;0;0;27412
2022-12-31 18:30;25784;289;493;0;0;26566
2022-12-31 19:30;24716;145;493;0;0;25354
2022-12-31 20:30;23967;118;493;0;0;24578
2022-12-31 21:30;22866;31;493;0;0;23390
2022-12-31 22:30;22409;33;492;0;0;22934
2022-12-31 23:30;22120;45;492;0;0;22657
;;;;;;
;;;;;;
;;;;;;
;;;;;;
;;;1074;10;418;